⽇	a
⽈	a
㍾	abeir
暈	abjj
冒	abu
㒻	abuu
㬙	aikf
㫤	aine
䳭	aislf
暑	ajka
暑	ajka
量	amwg
⾨	an
冕	anau
開	anmt
閭	anrhr
䦕	antt
𨵷	anwot
易	aphh
晴	aqmb
晴	aqmb
㍼	arhdr
最	asje
即	assl
暴	atce
⾉	av
㬈	awot
⽉	b
⺝	b
⺼	b
⾻	bbb
⻣	bbb
𣍟	bbm
𠕋	bbmm
䯎	bbomj
鼏	bbul
鼏	bbun
⺳	bc
贈	bccwa
贈	bccwa
賂	bcher
䐋	bcip
炙	bf
媵	bfqv
瞧	bgf
𦞵	bham
𦞧	bhhw
𧲨	bhmt
冗	bhu
⻅	bhu
⺱	bk
𦋙	bkhu
⽹	bkk
肋	bks
䏙	blbu
⺵	bll
⺴	blu
⼞	bm
䏕	bmg
⺜	bmm
𠕋	bmmb
脃	bnau
⾘	bnhh
⻉	bo
肭	bob
⽤	bq
周	bqr
彫	brhhh
𣎜	brxu
冤	bshi
⽫	bt
𠕋	btt
⽬	bu
⾙	buc
見	buhu
⾒	buhu
睊	buib
睊	buib
𥃲	bujj
朡	buke
䀹	bukoo
䀹	bukoo
䁆	bukux
具	bumc
𥄙	bumlc
𥃳	bumms
䀘	bumt
𥉉	buold
瞋	bupbc
亂	buu
⿍	buvml
臘	bvvv
脾	bwhj
爵	bwli
爵	bwli
丹	by
𣎓	byso
金	c
⾦	c
益	ccbt
鍊	cdwf
⺑	chn
𨯺	chxf
鋗	cib
鈸	cike
⽗	ck
鐕	ckua
⺏	clu
鉶	cmtn
鏹	cnri
鈴	coii
鈴	coml
⾕	cor
鋘	crvk
鉼	ctt
錄	cvne
⽊	d
欄	danw
𣑭	dbbm
刺	dbln
榣	dbou
㮝	dcrl
㮝	dcrl
林	dd
楂	ddbm
㓟	deln
隸	dfle
櫛	dhal
梎	dhap
⽪	dhe
柳	dhhl
槪	dhpu
⼨	di
𣏕	dijc
杖	dijk
樓	dllv
𪈎	dlmcf
⺘	dm
㍿	dmoig
⾱	dmrq
枅	dmt
李	dnd
杻	dng
𦖨	dnsj
櫓	dnwa
來	doo
梅	dowk
梅	dowy
杓	dpm
韛	dqthb
韠	dqwtj
柺	drks
𣏃	dsm
㰘	dsmt
杞	dsu
檨	dtgo
栟	dtt
椔	dvmw
𣚣	dwtc
⽔	e
𣽞	eahr
涅	eam
滑	ebbb
洞	ebmr
滛	ebou
梁	ecd
𣴞	echg
淋	edd
㴳	egip
洛	eher
派	ehhv
溜	ehhw
沿	ehnr
浩	ehqr
淚	ehsk
浪	eiav
潮	ejjb
渚	ejka
濆	ejtc
𣻑	ekce
淹	eklx
灊	ekub
𣲼	elbn
沈	elbu
汧	emjj
𣾎	emmf
汧	emt
湮	emwg
⺢	en
汎	enhi
溺	enmm
㶖	eolf
淪	eomb
瀹	eomb
海	eowk
海	eowy
滇	epbc
泌	eph
瀞	eqbd
瀞	eqbd
泍	eqc
洖	ervk
漏	esmb
浸	esme
濫	esmt
泥	esp
漢	etao
港	etcu
漢	etlo
洴	ett
滋	etvi
滋	etvi
流	eyiu
流	eyiu
流	eyiu
漣	eyjj
濾	eypp
瀛	eyqv
⽕	f
爛	fanw
⽶	fd
糧	fdamg
类	fdik
糖	fdilr
糣	fdkua
類	fdmbc
糨	fdnri
精	fdqmb
糒	fdthb
煉	fdwf
料	fdyj
粒	fdyt
勞	ffbks
瑩	ffbmi
燐	ffdq
𤎫	fftco
𤎫	fftf
虩	ffypu
省	fhbu
烙	fher
劣	fhks
熜	fhwp
⺗	fi
灷	fjj
燎	fkcf
煅	frse
当	fsm
懞	ftbo
兤	fuitc
𤉣	fvmw
爐	fypt
⼟	g
売	gbhn
塚	gbmo
塚	gbmo
壷	gbtm
穀	gdhne
穀	gfhne
𡓤	ghxc
城	gihs
報	gjrle
墳	gjtc
⾚	glnc
殻	gnhne
𠠄	gofbn
𧼯	goomv
起	gosu
𧻓	gott
埴	gpbv
嗀	grhne
切	gsh
堍	gshi
塀	gstt
⿎	gtje
⾛	gyo
⽵	h
㇒	h
⽩	ha
馧	haabt
⾹	had
𤾡	haikf
節	hail
𥳐	hant
𤾸	hatbf
⿃	hayf
爨	hbddf
𥮫	hbfd
䈧	hbhf
⾎	hbt
⾃	hbu
⾈	hbyi
劉	hcln
⽲	hd
穏	hdbsp
稜	hdhge
彩	hdhhh
秊	hdhj
秫	hdid
利	hdln
䄯	hdmt
⿉	hdoe
⼡	he
冬	hey
爫	hf
⺤	hf
⺥	hf
⾤	hfd
⺧	hg
珞	hgher
⺁	hh
卿	hhapl
⼺	hhh
卿	hhhil
⾡	hhho
卿	hhhpl
𨜮	hhisl
黎	hhoe
穊	hhpu
卵	hhsl
留	hhw
成	hin
節	hisl
簾	hitc
⾆	hjr
翺	hjsmm
懲	hkp
懲	hkp
懲	hkp
⺅	hl
齃	hlapp
堲	hlg
⽖	hlo
𡷦	hlu
⽄	hml
築	hmnd
⼏	hn
⺆	hn
⺇	hn
⺈	hn
㇢	hn
梨	hnd
⽎	hne
⾵	hnhli
𩖶	hnid
⻛	hnk
⼊	ho
⼋	ho
⼻	ho
徭	hobmu
徚	hodw
㣣	hokoo
律	holq
行	hommn
⾏	hommn
𣢧	hono
復	hooae
衠	hopcn
𠨬	hp
旣	hpmvu
卽	hpsl
⽜	hq
⽣	hqm
夆	hqqj
犕	hqthb
⽑	hqu
⾩	hrlj
⻕	hrlr
⼓	hs
⼾	hs
篆	hsmo
既	hsmvu
䈂	htt
䀈	hubt
䊠	hufd
⿁	hui
⻤	hui
臭	huik
𦓚	huumb
⿐	huwml
鼻	huwt
㇛	hv
⽠	hvio
⽒	hvp
𥲀	hvvd
卑	hwhj
卑	hwhj
⾅	hx
⺽	hx
⾝	hxh
䳎	hxhaf
𠔜	hxlmc
舁	hxt
舁	hxt
龜	hxu
龜	hxu
⻱	hxu
舄	hxvsf
⿏	hxvyv
籠	hybp
笠	hyt
䑫	hyyjj
⼂	i
⼽	i
㇔	i
良	iav
⼧	ib
䳸	ichaf
𪎒	idhni
摩	idq
⺣	if
⺭	if
禍	ifbbr
祖	ifbmm
視	ifbuu
視	ifbuu
社	ifg
𥛅	ifhlw
祈	ifhml
祐	ifkr
神	iflwl
福	ifmrw
𥘦	ifok
祝	ifrhu
福	ifslw
祥	iftq
禮	iftwt
礼	ifu
祿	ifvne
禎	ifybc
𥚚	ifyku
祉	ifylm
⼴	ih
廊	ihvl
⺀	ii
朗	iib
朗	iib
⺍	iih
參	iiih
廊	iiil
⽧	iim
麻	ijcc
⿇	ijcc
⽝	ik
⻰	ikp
啓	ikr
㡼	ilwp
⼇	im
⼎	im
凌	imge
次	imno
冷	imoii
冷	imoml
𩇟	imqbu
凉	imyrf
凜	imywd
⼍	in
盛	inbt
⻂	inlo
⻎	inno
辶	ino
⻌	ino
⻈	inv
⼷	ip
麟	ipfdq
𪊑	ipmt
廒	iqsk
唐	isjr
度	ite
庶	itf
庰	itt
廉	itxc
凞	iuf
鱀	iunwf
朗	ivb
⽞	ivi
剆	ivln
郎	ivnl
庳	iwlj
恵	iwp
廙	iwtc
鹿	ixp
⿅	ixp
⺖	iy
⺡	iy
⻍	iy
廓	iydl
廬	iypt
⼗	j
煮	jaf
煮	jaf
都	janl
直	jbmm
𩐊	jbmom
真	jbuc
直	jbuv
索	jbvf
⽳	jc
突	jcik
𥥼	jcjb
窱	jcold
⽀	je
鶴	jghaf
宅	jhp
牢	jhq
博	jiwi
戴	jiwtc
艹	jj
廾	jj
⼶	jj
⺾	jj
⺿	jj
卉	jjj
桒	jjjd
輻	jjmrw
輪	jjomb
輸	jjomn
輸	jjomv
軔	jjsk
轢	jjvid
⺹	jk
者	jka
者	jka
者	jka
寮	jkcf
老	jkp
⽼	jkp
吏	jlk
⼠	jm
寳	jmfc
賓	jmhc
𡧈	jmms
⿆	joni
寘	jpbc
寧	jpbn
寧	jpbn
寧	jpwn
憲	jqjp
割	jrln
⺺	js
寃	jshi
賁	jtbuc
塞	jtcg
鼖	jtgte
真	jumc
車	jwj
⾞	jwj
⼤	k
瘟	kabt
殺	kchne
閷	kdano
殺	kdhne
殺	kdhne
癩	kdlc
𪄅	kehaf
⺨	kh
獺	khdlc
痢	khdn
狼	khiav
𤠔	khibc
猪	khjka
猪	khjka
犯	khru
𤜵	khtt
獵	khvvv
奢	kjka
奔	kjt
⽘	kk
療	kkcf
奈	kmmf
㍽	kmym
丸	knk
瘐	kow
⻋	kq
力	ks
⼒	ks
尢	ku
⼪	ku
⺐	ku
㞁	kuap
瘝	kwle
奄	kwu
⼁	l
⼃	l
㇑	l
㇓	l
褐	lapv
⼱	lb
帽	lbabu
㡢	lbaws
帨	lbcru
幩	lbjtc
⽱	lbmi
𢆃	lbtye
⺌	lc
裞	lcru
懶	ldlc
⾪	le
書	lga
蝹	liabt
蟡	libhf
䗗	lihmt
蜎	liib
蝫	lijka
⺦	lim
蚈	limt
⻔	lis
蛢	litt
螆	litvi
䗹	litvp
蠟	livvv
蝹	liwot
螺	liwvf
蜨	liyso
裺	lkux
串	ll
牐	llhjl
⽚	llml
⺻	lm
㇗	lm
㇘	lm
将	lmbdi
壮	lmg
𦰶	lmgpr
⾍	lmi
北	lmp
北	lmp
⾮	lmsy
𧙧	lmt
艹	lmy
⻀	lmy
⾾	ln
⺉	ln
㇁	ln
㇚	ln
襁	lnii
䘵	lnme
冀	lpwtc
⾀	lq
⼌	ls
襤	lsmt
㠯	lss
⼉	lu
⺃	lu
㇟	lu
㇂	lv
㇃	lv
㇄	lv
㇙	lv
數	lvok
裸	lwd
叟	lwe
裡	lwg
叟	lwle
𤰶	lwlw
𢆟	lwtt
⺊	ly
裗	lyiu
⼀	m
㇀	m
㇐	m
鄑	manl
𩅅	mbett
覆	mbhoe
霣	mbibc
勵	mbks
⽽	mbll
戛	mbmi
⻚	mbo
零	mboii
零	mboml
𠄢	mbrm
露	mbrmr
靈	mbrro
⾴	mbuc
雷	mbw
祖	mcbm
⻄	mcw
⾣	mcwm
不	mf
灰	mf
禍	mfbbr
祖	mfbm
視	mfbuu
視	mfbuu
社	mfg
𥛅	mfhlw
祈	mfhml
㍻	mfih
祐	mfkr
神	mflwl
福	mfmrw
𥘦	mfok
祝	mfrhu
福	mfslw
祥	mftq
禮	mftwt
礼	mfu
祿	mfvne
禎	mfybc
𥚚	mfyku
祉	mfylm
王	mg
⺩	mg
玥	mgb
再	mgb
璘	mgfdq
㺬	mghni
⽟	mgi
瑱	mgjbc
琢	mgmso
瓊	mgnwe
玲	mgoii
玲	mgoml
瑜	mgomv
瑱	mgpbc
瑇	mgqmk
弄	mgt
璅	mgvvd
理	mgwg
琉	mgyiu
璉	mgyjj
⼚	mh
曆	mhda
歷	mhdm
𤘈	mhhx
⾄	mig
⼲	mj
㍻	mjihs
鳽	mjmjf
⽆	mku
⻗	mlbi
兩	mlbo
⾬	mlby
⼯	mlm
更	mlwk
画	mlwu
⼆	mm
麗	mmbbp
丽	mmbmb
⽰	mmf
⺬	mmf
辰	mmmo
⾠	mmmv
惡	mmp
况	mmrhu
况	mmrhu
⺂	mn
㇆	mn
㇕	mn
殟	mnabt
烈	mnf
型	mng
⾗	mnho
⽍	mni
⽡	mni
裂	mnihv
歹	mnk
列	mnln
殮	mnomo
甤	mohqm
䂖	mor
𧢮	mpbuu
⽯	mr
䃣	mrbhf
⿀	mrbj
磻	mrhdw
碑	mrhwj
磌	mrjbc
磌	mrjbc
磊	mrmrr
礪	mrmtb
硎	mrmtn
碌	mrnme
𥐝	mrpm
⾖	mrt
碌	mrvne
硫	mryiu
辞	mrytj
𥁄	msbt
晉	mta
⾑	mtb
㿼	mtbt
形	mthhh
𩒖	mtmbc
㼛	mtmvn
雃	mtog
揅	mtq
⻃	mtw
兀	mu
⺎	mu
頋	mumbc
頋	mumbc
頋	mumbc
䪲	mumbc
⼕	mv
⼖	mv
⽛	mvdh
⺛	mvu
賈	mwbuc
栗	mwd
酪	mwher
醙	mwhxe
⾯	mwsl
𩈚	mwtt
醴	mwtwt
龎	mybp
⼅	n
⼸	n
㇖	n
⾊	nau
⾓	nbg
勇	nbks
⻇	nboo
⻆	nbq
⼩	nc
⼦	nd
鱗	nffdq
㇇	nh
⼣	ni
⽭	ninh
多	nini
⾇	niq
⽨	niyo
⼜	nk
⻏	nl
⻖	nl
隣	nlfdq
陸	nlgcg
陵	nlge
隆	nlheg
降	nlheq
䧦	nlikf
陼	nljka
阮	nlmmu
陋	nlvb
㇅	nm
⼹	nmm
了	nn
㇎	nn
㇋	nn
乁	no
⽋	no
⻜	no
㇝	no
𠭣	noe
墬	nog
⾶	nohto
及	non
㇡	ns
㇌	ns
豕	nsho
⼄	nu
㇈	nu
㇍	nu
㇠	nu
弢	nue
弢	nue
勉	nuks
勉	nuks
⻠	nv
⺄	nv
㇊	nv
⼵	nvk
⻢	nvsm
⿂	nwf
魯	nwfa
勇	nwks
⻥	nwm
⻲	nwpw
⻳	nwu
龜	nxu
龜	nxu
⿔	nxu
⺪	nylm
⽦	nyo
⼈	o
㇏	o
內	ob
⾁	obo
侻	ocru
僧	ocwa
⾫	og
倂	ohtt
偺	ohya
⻟	oiai
⻞	oias
⾷	oiav
⻝	oiav
䬳	oifq
飢	oihu
領	oimbc
念	oinp
⺮	oioi
餩	oioyo
什	oj
⽸	oju
⼢	ok
⽮	ok
⺙	ok
僚	okcf
㺸	okmg
㺸	okmgi
繁	okvif
絛	olhef
領	olmbc
愈	ombp
全	omg
便	omlk
⽓	omn
例	omnn
⻐	omp
⿕	omrb
令	omsl
侀	omtn
像	onbo
㔕	onks
仌	oo
你	oof
倫	oomb
侮	oowk
侮	oowy
年	oq
舘	orjrr
鼅	orrxu
飯	oshe
館	osjrr
飼	ossmr
備	otmb
僧	otwa
𦈨	oumt
㒞	ouos
𦉇	oustt
缾	outt
𪃎	ovhaf
敏	owok
𣫺	oykib
敏	oyok
⼼	p
𣊸	pavnb
惘	pbtv
眞	pbvc
㒹	pcpbc
憎	pcwa
憎	pcwa
憎	pcwa
懶	pdlc
𢛔	pdwf
憐	pfdq
𢡄	phka
𢡊	phkp
慨	phsu
勺	pi
悁	pib
㤜	pihm
慎	pjbc
駂	pjsqf
憤	pjtc
慎	pjuc
𠣞	pjwj
匆	pkk
慺	pllv
勺	pm
忹	pmg
慄	pmwd
⻓	po
怜	poii
怜	poml
悔	powk
悔	powy
⽐	pp
慠	pqsk
句	pr
切	psh
包	psu
懞	ptbo
慌	ptiu
慌	ptvu
惇	pysd
⻦	pysm
㤺	pyvu
⼿	q
撝	qbhf
撚	qbkf
⽾	qd
𦔣	qdisk
㨮	qhan
𢬌	qhie
契	qhk
揤	qhpl
搜	qhxe
捐	qib
拔	qike
𢯱	qjfe
寿	qkdi
憯	qkua
掩	qkux
⾭	qmb
⻘	qmb
⾭	qmblm
搢	qmca
⻨	qmhe
扝	qmks
拓	qmr
摾	qnri
捨	qogr
捻	qoip
輦	qojwj
揄	qomn
拾	qomr
志	qp
抱	qpsu
⻙	qs
挽	qshu
掃	qsmb
敖	qsok
摒	qstt
拼	qtt
摷	qvvd
㩬	qyci
擄	qyps
掠	qyrf
拉	qyt
⼝	r
嗢	rabt
喝	rapp
喝	rapv
⾢	rau
嗂	rbou
喳	rdbm
喇	rdln
噑	rhaj
吆	rhi
呂	rhr
噴	rjtc
呈	rmg
路	rmher
跋	rmike
趼	rmmt
咞	rmt
跰	rmtt
喙	rnmo
吸	rnon
啣	roul
叱	rp
啕	rpov
⻪	rpw
喫	rqhk
鷺	rrhaf
器	rrikr
咢	rrmks
喙	rsmo
嘆	rtao
嘆	rtlo
哶	rtq
⺒	ru
巽	rutc
叫	rvl
⺠	rvp
咽	rwk
黾	rwu
⿌	rxu
⻊	rylm
⾜	ryo
⼫	s
層	scwa
尿	se
䵖	sehde
犀	sehq
駾	sfcru
駱	sfher
驪	sfmmp
⼑	sh
免	shahu
免	shau
兔	shaui
戮	shi
刃	shi
忍	ship
鬒	shjbc
鬒	shjbc
𡬘	shjtu
𩬰	shmhn
履	shoe
⾽	sihhh
⽿	sj
聰	sjhwp
屠	sjka
聆	sjoii
聆	sjoml
聠	sjtt
聯	sjvit
⼙	sl
屢	sllv
⾲	slmm
臨	slorr
⾂	slsl
⺕	sm
㣇	smhb
⻒	smi
⽻	smsim
羽	smsmm
⾧	smv
⻑	smv
𣪍	snhne
⾺	sqsf
匿	stkr
⼰	su
⺋	su
𤋮	suf
邔	sunl
莭	tail
𦳕	tajt
藺	tang
䕡	tanr
蘭	tanw
菜	tbd
荣	tbd
劳	tbks
益	tcbt
⿋	tcfb
㭉	td
落	tehr
𦼬	temt
蓱	tett
⺷	tg
菱	tgce
勤	tgks
善	tgtr
善	tgtr
羕	tgye
着	thbu
⾸	thbu
䕝	thdb
蘒	thdu
菧	tihp
芝	tino
著	tjka
著	tjka
勒	tjks
苦	tjr
䩮	tjsme
䩶	tjumi
若	tkr
若	tkr
莽	tkt
𧏊	tlii
⾰	tlj
⻩	tlwc
⽢	tm
𦵫	tmbf
芋	tmd
黹	tmfb
茣	tmk
勤	tmks
⿈	tmlc
華	tmtj
芽	tmvh
䔫	tnmb
茶	tod
𦬼	tof
蕤	tohqm
難	toog
難	toog
花	top
荒	tovu
菊	tpfd
葉	tptd
⽺	tq
⺶	tq
⺸	tq
着	tqbu
羚	tqoii
羚	tqoml
𦾱	tqvd
敬	trok
茝	tsll
蓼	tsmh
藍	tsmt
芑	tsu
蓳	ttlg
並	ttm
頩	ttmbc
郱	ttnl
𠔥	ttsf
荓	ttt
𧃒	tvfv
甆	tvin
慈	tvip
菉	tvne
菌	twhd
蘿	twlg
夢	twln
蓮	tyjj
蔖	typm
蘆	typt
䕫	tyue
⼭	u
屮	uh
⼔	uh
嵐	uhni
𡴋	uhwy
⾿	uiip
炭	ukf
屮	ul
⼬	ul
峀	ulw
岍	umjj
蚩	umlmi
豈	umrt
嶲	uogs
嶺	uoic
嶺	uolc
崙	uomb
嵮	upbc
𡷤	urvk
嵫	utvi
⾋	uu
芳	uuyhs
嵃	uymh
嵼	uymm
女	v
⼥	v
娧	vcru
嬾	vdlc
嬾	vdlc
鄛	vdnl
怒	vep
拏	veq
縂	vfcrp
練	vfdw
練	vfdwf
練	vfdwf
綾	vfgce
鸞	vfhaf
變	vfhe
縷	vfllv
縉	vfmca
䌁	vfmwv
紐	vfng
綠	vfnve
戀	vfp
紀	vfsu
絣	vftt
緇	vfvmw
𥾆	vfvu
繅	vfvvd
䌴	vfyqq
嬈	vggn
嬈	vggu
⼛	vi
⼳	vi
⺓	vi
樂	vid
樂	vid
樂	vid
⽷	vif
⺯	vif
㛮	vjce
𡛪	vkuh
凵	vl
⼐	vl
蠁	vllmi
響	vlyta
響	vlyta
㇜	vm
災	vmf
𦇚	vmftf
狀	vmik
㛼	vmjx
⽙	vml
甾	vmw
㇞	vn
⺔	vnm
𡚨	vp
娛	vrvk
㇉	vs
姬	vsll
婦	vsmb
姘	vtt
嬨	vtvp
巢	vvhxd
⺰	vvm
災	vvmf
⻡	vvmhu
⼮	vvv
婢	vwhj
⽥	w
㱎	wfno
里	wg
⾥	wg
⿊	wgf
墨	wgfg
略	wher
圗	wiyw
⽏	wk
𥄳	wle
署	wljka
⺫	wll
⺲	wll
䍙	wlowy
罹	wlpog
羅	wlvfg
𦌾	wlvfv
罺	wlvvd
囹	woii
囹	woml
圖	wrkw
異	wtc
異	wtc
𤲒	wtt
累	wvif
壘	wwwg
貫	wybuc
⺟	wyi
㇣	xxxxx
⼘	y
望	ybhg
望	ybmg
離	ybog
龍	ybysp
⿓	ybysp
六	yc
歔	ycno
𣀊	ycok
⽁	ye
變	yfhe
虧	ygmks
頻	yhmbc
頻	yhmbc
⽅	yhs
⾐	yhv
𨗭	yhxg
育	yib
充	yihu
𠘺	yihu
率	yioj
率	yioj
⽃	yj
贛	yjhec
連	yjwj
鵧	yjyjf
⽂	yk
遼	ykcf
⻬	ykll
吝	ykr
⻫	yksl
⽌	ylm
𨗒	ymbg
歲	ymihf
剷	ymln
⾔	ymmr
⻭	ymufd
⻮	ymuo
⿒	ymuoo
逸	ynai
逸	ynai
⺞	yni
刻	yoln
衣	yoo
⾌	yp
壟	ypg
⻁	yphn
聾	ypsj
虐	ypsm
盧	ypwbt
虜	ypwks
虜	ypwks
謁	yrapp
謁	yrapv
調	yrbgr
⾼	yrbr
亮	yrbu
䛇	yrcr
說	yrcru
說	yrcru
讀	yrgwc
誠	yrihl
諸	yrjka
諸	yrjka
䚾	yrmg
𧥦	yrmms
論	yromb
諭	yromn
諭	yromv
請	yrqmb
謹	yrtag
諾	yrtkr
諾	yrtkr
謹	yrtlm
識	yryia
諒	yryrf
遲	yseq
𢌱	ysmt
𢌱	ysmt
旅	ysohv
立	yt
⽴	yt
暜	yta
⾳	yta
⾟	ytj
𥪧	ytjbc
𥪧	ytpbc
靖	ytqmb
靖	ytqmb
竮	ytstt
⻯	ytwu
𪘀	yutt
巡	yvvv
裏	ywgv
⿄	ywii
⻧	ywk
邏	ywlg
⿑	yx