鿰	ejjs
鿱	mgau
鿲	mttbs
鿳	nfhyp
鿴	nmhem
鿴	nmhey
鿵	nmgp
鿶	nmiav
鿷	nmyta
鿸	nmhyp
鿹	nmjpu
鿺	qehym
鿻	xvklb
鿼	xvksr
䶶	ymqo
䶷	rhu
䶷	rlu
䶸	rhi
䶹	uh
䶹	ul
䶺	bob
䶻	blbu
䶼	bcip
䶽	buce
䶾	xono
䶿	oilu
䶿	oihu
䶿	oslu
䶿	oshu
𪛗	orn
𪛘	wcn
𪛘	whun
𪛙	mn
𪛚	ymn
𪛛	son
𪛜	mn
𪛝	hnin
𰀀	mu
𰀁	jj
𰀂	sj
𰀃	mb
𰀄	sm
𰀅	knkm
𰀆	mt
𰀇	msms
𰀈	qni
𰀉	jl
𰀊	lbms
𰀋	julll
𰀌	mrlb
𰀍	mfmvh
𰀎	ymymm
𰀏	pav
𰀏	ymav
𰀐	mhui
𰀑	hidh
𰀒	mobb
𰀓	mwgn
𰀔	mahn
𰀕	mbmob
𰀖	mwim
𰀗	ymym
𰀘	mfjo
𰀙	mkhsb
𰀙	mkisb
𰀙	mkmsb
𰀚	mfmk
𰀛	maag
𰀜	mxph
𰀝	bmbmm
𰀞	mwskm
𰀟	mfdx
𰀠	lo
𰀡	lle
𰀢	lloi
𰀣	vqo
𰀤	almg
𰀥	rrnz
𰀦	rrrr
𰀧	vbgr
𰀨	wfll
𰀩	ygyg
𰀪	hh
𰀫	ln
𰀬	nhvo
𰀭	hdpks
𰀮	hrdb
𰀯	nhev
𰀰	nnn
𰀱	vvvv
𰀲	mfn
𰀳	niku
𰀴	hqun
𰀵	huv
𰀶	fbn
𰀷	uuu
𰀸	pdpd
𰀹	hdn
𰀺	ieu
𰀺	meu
𰀻	sru
𰀼	nir
𰀽	mwn
𰀾	mcwv
𰀿	oin
𰁀	nhh
𰁀	ntt
𰁁	gyon
𰁂	bsn
𰁃	omcn
𰁄	bmcn
𰁅	rdn
𰁆	orn
𰁇	knije
𰁈	islk
𰁉	amyn
𰁊	bnn
𰁋	nrrr
𰁌	nytt
𰁍	wzn
𰁎	csn
𰁏	nyll
𰁐	yawv
𰁑	bdhgu
𰁒	nnnn
𰁓	qinsd
𰁔	mxnsd
𰁕	pmm
𰁖	mmol
𰁗	mmso
𰁘	mgpm
𰁙	mmlb
𰁚	mmoi
𰁛	mmie
𰁜	yllc
𰁝	yvbb
𰁞	ywle
𰁟	yvehr
𰁠	yumis
𰁡	oo
𰁢	os
𰁣	on
𰁤	muo
𰁥	obe
𰁦	ook
𰁧	ooo
𰁨	olll
𰁨	olls
𰁩	oyj
𰁪	oee
𰁫	oqmn
𰁬	obk
𰁭	obn
𰁮	hao
𰁯	ose
𰁰	llno
𰁱	okru
𰁲	ojbm
𰁳	oshl
𰁴	ogmd
𰁵	ognd
𰁶	oipu
𰁷	oln
𰁸	ofs
𰁹	oaj
𰁺	oybk
𰁻	orlb
𰁼	ohbr
𰁽	ololl
𰁾	onbo
𰁿	owr
𰂀	ohmr
𰂁	oykn
𰂂	oem
𰂃	osdi
𰂄	onom
𰂅	oru
𰂆	ogug
𰂇	obuc
𰂈	oev
𰂉	ooby
𰂊	okkr
𰂋	olsa
𰂌	ohsr
𰂌	oisr
𰂍	oife
𰂎	olsb
𰂏	ojnk
𰂐	oikh
𰂑	omlb
𰂒	obtu
𰂓	ohjp
𰂔	oysm
𰂔	oysy
𰂕	ofb
𰂖	onmy
𰂗	otjb
𰂘	oktq
𰂙	ohyn
𰂚	oab
𰂛	ougi
𰂜	olmo
𰂝	oxmj
𰂞	ohsb
𰂞	oisb
𰂟	omem
𰂟	onrm
𰂠	ovfi
𰂡	oeeg
𰂢	omwp
𰂣	omws
𰂤	doyj
𰂥	odht
𰂦	oypp
𰂧	orcg
𰂨	oyhr
𰂩	oifm
𰂩	omfm
𰂪	obck
𰂫	ofqh
𰂬	onwa
𰂭	oboh
𰂮	oxmh
𰂯	ohlq
𰂰	otla
𰂰	otta
𰂱	ofbq
𰂲	ofbu
𰂳	oybj
𰂴	ockl
𰂵	ohfp
𰂶	oywv
𰂷	oioc
𰂷	omoc
𰂸	ocwo
𰂹	ojtn
𰂺	omglr
𰂻	obfo
𰂼	ocru
𰂽	onwcl
𰂾	okma
𰂿	donew
𰃀	ojhw
𰃁	oyif
𰃁	oykf
𰃂	ogrf
𰃃	tsomd
𰃄	doomn
𰃅	opdz
𰃆	ohuo
𰃇	ossc
𰃈	onhbo
𰃉	oafz
𰃊	luym
𰃋	nhru
𰃌	fmuks
𰃍	jrfu
𰃎	halu
𰃏	muhjg
𰃐	fuikh
𰃐	fuiuh
𰃑	fuelw
𰃒	fuphp
𰃓	jmxhu
𰃔	fufbu
𰃕	fumzu
𰃖	ott
𰃗	ojb
𰃘	ofk
𰃙	hmro
𰃚	ojwj
𰃛	mto
𰃜	optd
𰃝	tkni
𰃞	oyc
𰃟	auc
𰃠	ciob
𰃡	rnc
𰃢	cspa
𰃣	ycor
𰃤	fkng
𰃥	ycmwv
𰃦	hb
𰃧	bhg
𰃨	bime
𰃩	bta
𰃪	bvvx
𰃫	jrb
𰃬	tbon
𰃭	boboo
𰃮	fb
𰃯	bmfj
𰃰	blw
𰃱	bvvw
𰃲	bedd
𰃳	byjo
𰃴	byjc
𰃵	imj
𰃶	imhnk
𰃷	imosu
𰃸	imhs
𰃸	imis
𰃹	imyt
𰃺	imdhe
𰃻	imppj
𰃼	imkn
𰃽	impa
𰃾	imiav
𰃿	imjnk
𰄀	imqyt
𰄁	imikh
𰄂	imjir
𰄃	immwg
𰄄	imtbn
𰄅	imjbf
𰄆	imfbu
𰄇	ilsp
𰄈	immzs
𰄉	imlnb
𰄊	imssa
𰄋	ildw
𰄌	imbta
𰄍	imygq
𰄎	imbdb
𰄏	imnwa
𰄐	hnobt
𰄑	oux
𰄒	uxym
𰄓	xuhem
𰄓	xuhey
𰄔	uuuu
𰄕	uukld
𰄖	kixu
𰄗	xumlp
𰄘	uuykj
𰄙	cln
𰄚	smln
𰄛	shpi
𰄛	shpm
𰄜	pln
𰄝	nhhln
𰄞	qniln
𰄟	mfln
𰄠	mish
𰄡	shphh
𰄢	yksh
𰄣	lpsh
𰄤	shpru
𰄤	shpsu
𰄥	shyk
𰄦	ytsh
𰄧	shmnn
𰄨	kqln
𰄩	hbuln
𰄪	kdsh
𰄫	shhbr
𰄬	ykln
𰄭	mbbln
𰄮	shije
𰄯	ktln
𰄰	negln
𰄱	chjz
𰄲	nsfh
𰄳	gmsh
𰄴	kush
𰄵	knsh
𰄶	shikh
𰄷	shqhr
𰄸	shbcn
𰄹	bclnh
𰄺	ybbln
𰄻	yjjn
𰄼	knam
𰄽	vlsh
𰄾	jokln
𰄿	gtsh
𰅀	shddd
𰅁	shjrn
𰅂	sqaln
𰅃	ddcsh
𰅄	jbfln
𰅅	tsmnn
𰅆	dnjbl
𰅇	yksh
𰅈	nauln
𰅉	ttks
𰅊	amks
𰅋	lmpks
𰅌	ksrup
𰅍	ktks
𰅎	kshon
𰅏	krys
𰅐	nsbt
𰅑	ttwks
𰅒	kvks
𰅓	auks
𰅔	yppks
𰅕	twaks
𰅖	mnvks
𰅗	kshhq
𰅘	bsjmf
𰅙	mthgs
𰅚	kriop
𰅛	pc
𰅜	phhw
𰅝	nupi
𰅝	nupm
𰅞	okpru
𰅟	putc
𰅠	kipru
𰅡	dhp
𰅢	ppno
𰅣	julmp
𰅤	shd
𰅥	sjnk
𰅦	scwj
𰅧	sdbu
𰅨	sjjl
𰅩	sxoc
𰅪	sje
𰅫	snim
𰅬	srde
𰅭	cj
𰅮	nhj
𰅯	nnnj
𰅰	jblm
𰅱	ukj
𰅲	ptj
𰅳	kcj
𰅴	jbk
𰅵	pkuj
𰅶	jrau
𰅷	jvvx
𰅸	jsmv
𰅹	jble
𰅺	wohj
𰅻	ojwl
𰅼	fqdf
𰅽	tviti
𰅾	ysht
𰅿	fqgth
𰆀	jbjb
𰆁	httag
𰆂	jbjbb
𰆃	ywk
𰆄	yalm
𰆅	ywmr
𰆆	yhnmb
𰆇	ybee
𰆈	yncik
𰆉	ybesj
𰆊	sl
𰆋	slsl
𰆌	asl
𰆍	ojsl
𰆎	bsli
𰆏	husl
𰆐	wgsl
𰆑	qasl
𰆒	hfsl
𰆓	kesli
𰆔	dqhvl
𰆕	mik
𰆖	mmmu
𰆗	myk
𰆘	mhqm
𰆙	mdt
𰆚	mofm
𰆛	mipu
𰆜	myfe
𰆝	mays
𰆞	mxkn
𰆟	mfb
𰆠	miav
𰆡	mggo
𰆢	mgge
𰆣	mgge
𰆤	mhse
𰆥	mytu
𰆦	mvjh
𰆧	mopr
𰆨	mtc
𰆩	mhqv
𰆪	mtbk
𰆫	mitgt
𰆬	mfmhf
𰆭	ihni
𰆮	ikmmu
𰆯	giwg
𰆰	ohe
𰆱	mfe
𰆲	ume
𰆳	eop
𰆴	yye
𰆵	nej
𰆶	eal
𰆷	ekun
𰆸	bue
𰆹	lwe
𰆺	ose
𰆻	egg
𰆼	sesle
𰆽	eepi
𰆾	neyt
𰆿	oose
𰇀	yoe
𰇁	eiikh
𰇂	bsje
𰇃	eeeo
𰇄	oehe
𰇅	ebekb
𰇆	emsbe
𰇇	rmm
𰇈	crs
𰇉	nr
𰇊	rqni
𰇋	byr
𰇌	htr
𰇍	eer
𰇎	rkd
𰇏	rbu
𰇐	rw
𰇑	bbr
𰇒	roon
𰇓	rylb
𰇔	qorp
𰇕	rkt
𰇖	rmis
𰇗	rqr
𰇘	rbon
𰇙	byrp
𰇚	rnoy
𰇛	roik
𰇜	ronk
𰇝	inoe
𰇞	rykn
𰇟	ibfr
𰇠	krop
𰇡	rvmn
𰇢	red
𰇣	rei
𰇤	mrrp
𰇥	ryms
𰇦	rgpu
𰇧	rgdk
𰇨	rcrp
𰇩	bcr
𰇪	rrl
𰇫	rrau
𰇬	rhvl
𰇭	jivr
𰇮	neor
𰇯	slr
𰇰	rsqn
𰇱	rshmr
𰇲	rono
𰇳	rnai
𰇴	oryt
𰇵	rhsl
𰇵	risl
𰇵	rmsl
𰇶	rkl
𰇷	rysk
𰇸	ryvu
𰇹	regi
𰇺	ilor
𰇻	rnzo
𰇼	rikh
𰇽	rnhi
𰇾	smrr
𰇿	mrtp
𰈀	gyop
𰈁	rqlo
𰈂	rmgk
𰈃	rqpa
𰈄	rqor
𰈅	wsrp
𰈆	rliu
𰈇	rfbi
𰈈	rypb
𰈉	rlpb
𰈊	ryrf
𰈋	rkhi
𰈌	ehrp
𰈍	rylc
𰈎	rjyf
𰈏	rnht
𰈐	rvvu
𰈑	tzrp
𰈒	rmbp
𰈓	rlit
𰈔	rwmo
𰈕	hlrp
𰈕	ilrp
𰈖	lyrp
𰈗	orrp
𰈘	rhod
𰈙	rhyn
𰈚	rjoc
𰈛	ivhmr
𰈜	lhhbr
𰈝	rndc
𰈞	rvnd
𰈟	hrhkr
𰈟	mrmkr
𰈠	pgrp
𰈡	rfbk
𰈢	rham
𰈣	rolb
𰈤	rhyt
𰈥	rbcu
𰈦	rort
𰈧	hrr
𰈨	ryhj
𰈩	mrrrn
𰈪	rirp
𰈫	mgjr
𰈬	rrru
𰈭	rogf
𰈮	rvmj
𰈯	rjbk
𰈰	rabe
𰈱	rhxo
𰈲	rcho
𰈳	orbr
𰈴	icrp
𰈵	bmrp
𰈶	rvmi
𰈷	qlrp
𰈸	rseo
𰈹	rdll
𰈺	ger
𰈻	rjpru
𰈼	roiz
𰈼	rolz
𰈽	yrnqd
𰈾	rijz
𰈿	ryej
𰉀	romc
𰉁	ryho
𰉂	ryrk
𰉃	reti
𰉄	rhuo
𰉅	rcbu
𰉆	rqjn
𰉇	grxb
𰉈	najr
𰉉	rnfq
𰉊	rouj
𰉋	ripk
𰉌	rypy
𰉍	won
𰉎	wvm
𰉏	wyr
𰉐	wcmm
𰉑	wkl
𰉒	koow
𰉓	wrkl
𰉔	wmmz
𰉕	gs
𰉖	gs
𰉗	fg
𰉘	gqs
𰉙	gbk
𰉚	gbhu
𰉛	mkg
𰉜	gon
𰉝	ghqu
𰉞	gnl
𰉟	glmp
𰉠	ghke
𰉡	ghem
𰉡	ghey
𰉢	ytg
𰉣	geq
𰉤	dheg
𰉥	gkt
𰉦	gkb
𰉧	mikg
𰉨	guq
𰉩	gmkl
𰉪	gopj
𰉫	gohl
𰉬	ghnn
𰉭	gpa
𰉮	gdl
𰉯	ihsg
𰉰	gjbk
𰉱	gofm
𰉲	gnau
𰉲	gshu
𰉳	ghmb
𰉴	gjcs
𰉵	gshu
𰉶	ger
𰉷	grg
𰉸	mug
𰉹	dig
𰉺	gpfd
𰉻	gbbe
𰉼	bbg
𰉽	gfbd
𰉾	gyok
𰉿	icfg
𰊀	vrg
𰊁	gdhy
𰊂	gtjb
𰊃	gmgt
𰊄	gfhu
𰊅	gnay
𰊆	gmke
𰊇	erg
𰊈	vig
𰊉	ibg
𰊊	gtv
𰊋	gstu
𰊌	gmg
𰊍	ggrv
𰊎	kgmdr
𰊏	gmrd
𰊐	gwce
𰊑	glit
𰊒	gtsm
𰊓	gwlu
𰊔	ghup
𰊕	gfbmr
𰊖	edg
𰊗	gbnog
𰊘	gndf
𰊙	geg
𰊚	gtlo
𰊛	gslo
𰊜	gqmc
𰊝	gjbd
𰊞	gybb
𰊟	gtmb
𰊠	gfbb
𰊡	glsx
𰊢	elg
𰊣	efg
𰊤	itfg
𰊥	ganr
𰊦	ggrr
𰊧	gjbd
𰊨	gand
𰊩	rrg
𰊪	rrslg
𰊫	ghlq
𰊬	gors
𰊭	yhllg
𰊮	gomw
𰊯	heg
𰊰	gymrt
𰊱	gyfu
𰊲	lkg
𰊳	guhk
𰊴	mwg
𰊵	ggyt
𰊶	twbg
𰊷	gbaa
𰊸	gime
𰊹	gmrz
𰊺	gfba
𰊻	ggwc
𰊼	gypb
𰊽	rng
𰊽	rug
𰊾	guwf
𰊿	vkg
𰋀	gviw
𰋁	mjg
𰋂	gtye
𰋃	gffe
𰋄	gssc
𰋅	geii
𰋆	gfbf
𰋇	guffd
𰋈	gby
𰋉	gggm
𰋊	magbn
𰋋	gthem
𰋋	gthey
𰋌	ghmvm
𰋍	gusrg
𰋎	okmso
𰋎	hemso
𰋏	pmre
𰋐	nnkn
𰋑	nntc
𰋒	nnemy
𰋓	nnryo
𰋔	nngcg
𰋕	nnjmf
𰋖	fvnin
𰋗	dnhvd
𰋘	junin
𰋙	bk
𰋚	mk
𰋛	kpo
𰋜	kkk
𰋝	ssk
𰋞	kmx
𰋟	mkmk
𰋠	qkpu
𰋡	mkkhu
𰋢	kwks
𰋣	hqhqo
𰋤	kyoye
𰋥	hhk
𰋦	konhe
𰋧	ffk
𰋨	mak
𰋩	mkmk
𰋪	mkqyt
𰋫	kik
𰋬	cryk
𰋭	mkahm
𰋮	mkjju
𰋯	mkybs
𰋰	ykbcn
𰋱	tryk
𰋲	koshh
𰋲	kostt
𰋳	keem
𰋴	bkbvk
𰋵	iv
𰋶	vks
𰋷	fv
𰋸	vnhh
𰋹	vqni
𰋺	vf
𰋻	vah
𰋼	vhke
𰋽	mikv
𰋾	vppj
𰋿	vma
𰌀	tbv
𰌁	vumn
𰌂	vybo
𰌃	vox
𰌄	vyk
𰌅	quv
𰌆	klv
𰌇	vqmo
𰌈	vjbm
𰌈	vjbv
𰌉	vrlu
𰌊	vmuu
𰌋	van
𰌌	gtv
𰌍	vktq
𰌎	vbir
𰌏	vbbb
𰌐	vtaj
𰌑	rbv
𰌒	vhwp
𰌓	vbnib
𰌔	vfdj
𰌕	fvss
𰌖	vjpt
𰌗	vndk
𰌘	gev
𰌙	vdlo
𰌚	ukv
𰌛	vhja
𰌜	nddh
𰌝	ndhp
𰌞	mmcd
𰌟	ndmmi
𰌠	ndx
𰌡	ndye
𰌢	ndng
𰌣	ndok
𰌤	ndoni
𰌤	ndosl
𰌥	ndjmn
𰌦	ndml
𰌧	ndmbl
𰌨	ndfb
𰌩	dood
𰌪	ndtz
𰌫	ndkmf
𰌬	ndabu
𰌭	ndyth
𰌭	ndykh
𰌮	undf
𰌯	ndwvf
𰌰	jrfbd
𰌱	sdsdd
𰌲	qdytu
𰌳	jvv
𰌴	jmmm
𰌵	jei
𰌶	jmf
𰌷	jiks
𰌸	jsk
𰌹	jjt
𰌺	jrsl
𰌻	jklg
𰌼	jma
𰌽	jvr
𰌾	jmsx
𰌿	jmvm
𰍀	joyg
𰍁	juhq
𰍂	jdhe
𰍃	jhtl
𰍄	jhrj
𰍅	jsuu
𰍆	jmfb
𰍇	jtmd
𰍈	jife
𰍈	jmfe
𰍉	jtcn
𰍊	jtkr
𰍋	jpkp
𰍌	jetc
𰍍	jpor
𰍎	qijmo
𰍏	jmhf
𰍐	jtch
𰍑	jukd
𰍒	jmad
𰍓	jwle
𰍔	jtgf
𰍕	jlye
𰍖	jpyr
𰍗	jssd
𰍘	jejj
𰍙	jlre
𰍚	jvwln
𰍛	jujrr
𰍜	jogd
𰍝	jrqnd
𰍞	jhbk
𰍟	jhyr
𰍠	jveb
𰍡	jnyc
𰍢	jrjcr
𰍣	sbjhp
𰍤	ybjti
𰍥	rigdi
𰍦	sitmd
𰍧	hn
𰍨	ni
𰍩	fo
𰍪	xf
𰍫	fyhv
𰍬	ypfh
𰍭	muhqm
𰍮	kujv
𰍯	ajiku
𰍰	sm
𰍱	sqni
𰍲	syc
𰍳	ssf
𰍴	sen
𰍵	rcso
𰍶	shon
𰍷	syuk
𰍸	sqje
𰍹	sjwj
𰍺	suk
𰍻	seg
𰍼	spkdi
𰍽	sqmb
𰍾	shdu
𰍿	shju
𰎀	sojll
𰎁	sfdu
𰎂	seshu
𰎃	sgnin
𰎄	sudoo
𰎅	suaa
𰎆	shku
𰎇	trshu
𰎈	ueel
𰎉	un
𰎊	phu
𰎋	ub
𰎌	uoo
𰎍	uihu
𰎎	uikp
𰎏	ukd
𰎐	uys
𰎑	ul
𰎒	uha
𰎓	uvis
𰎔	ujpu
𰎕	mnuau
𰎖	ubon
𰎗	ubln
𰎘	uahi
𰎙	uone
𰎚	hmru
𰎛	uomi
𰎜	uyck
𰎝	ubkq
𰎞	uhbv
𰎟	ukoo
𰎠	umlh
𰎡	umgk
𰎢	uwqs
𰎣	hpu
𰎣	ipu
𰎤	upbn
𰎥	ugcg
𰎦	usko
𰎧	hrju
𰎨	hiu
𰎨	hku
𰎩	umad
𰎪	ujeu
𰎫	ukhk
𰎬	hju
𰎭	uybu
𰎮	umwp
𰎯	ugnh
𰎰	usfb
𰎱	uubb
𰎲	uvmi
𰎳	ufbg
𰎴	usqme
𰎵	urru
𰎶	urru
𰎷	uhro
𰎸	utqr
𰎹	ujbk
𰎺	uihp
𰎻	umix
𰎼	usro
𰎽	uuprs
𰎾	uhkg
𰎿	uurtm
𰏀	uyev
𰏁	uhuo
𰏂	uurk
𰏃	lllm
𰏄	vvaj
𰏅	mmbnd
𰏆	vvwbb
𰏇	kmn
𰏈	mi
𰏉	mskn
𰏊	mki
𰏋	mkr
𰏌	kmmcw
𰏍	kmumg
𰏎	tmnsd
𰏎	tmbsd
𰏏	srru
𰏐	ddsu
𰏑	shlb
𰏒	lblb
𰏓	lbhvm
𰏔	lbyhn
𰏕	lbij
𰏖	lbhio
𰏗	lblbb
𰏘	fbf
𰏙	hrjb
𰏚	tbdh
𰏛	hlvvw
𰏜	lbfdv
𰏝	hbniy
𰏞	gilb
𰏞	gklb
𰏟	lblsw
𰏠	lbddo
𰏡	kbifp
𰏢	mju
𰏣	mnmfj
𰏤	oomt
𰏥	oloq
𰏦	mjmfj
𰏧	ysoq
𰏨	mjomh
𰏩	gtmj
𰏪	drmj
𰏫	oqor
𰏬	rrrf
𰏭	ylmj
𰏮	glpfd
𰏯	vihu
𰏰	vism
𰏱	vvig
𰏲	ism
𰏳	ilwl
𰏴	il
𰏵	fui
𰏶	iomi
𰏷	idhi
𰏸	iws
𰏹	iqkq
𰏺	iokr
𰏻	iede
𰏼	itjb
𰏽	iktg
𰏾	ihse
𰏿	iyjj
𰐀	ihqv
𰐁	iiib
𰐁	iivb
𰐂	ienin
𰐃	igot
𰐄	ieyhl
𰐅	iejz
𰐆	ixyk
𰐇	ymt
𰐈	vt
𰐉	ppt
𰐊	mnmt
𰐋	wrmjj
𰐋	wrmkj
𰐋	wrmt
𰐌	ddt
𰐍	wli
𰐎	ipamj
𰐏	ipnbg
𰐏	ipnbq
𰐐	ipymr
𰐑	ipssa
𰐒	ipooa
𰐓	nrmm
𰐔	nam
𰐕	pplln
𰐖	llnh
𰐗	nijb
𰐘	nrms
𰐙	nmpx
𰐚	nnwm
𰐛	ntgu
𰐛	ntqu
𰐜	numb
𰐝	lnijb
𰐞	nyaf
𰐟	ntak
𰐠	muncj
𰐡	ypobc
𰐢	yggn
𰐣	sqyt
𰐤	hms
𰐥	sfdh
𰐦	hqhhh
𰐧	ythhh
𰐨	tthhh
𰐩	bshhh
𰐪	yrhhh
𰐫	fvhhh
𰐬	holll
𰐭	hoha
𰐮	hojbu
𰐯	hord
𰐰	hojwi
𰐱	hoyfe
𰐲	hohua
𰐳	hoshq
𰐴	homgk
𰐵	hobbr
𰐶	hovix
𰐷	hoawe
𰐸	hoavg
𰐹	hoywg
𰐺	np
𰐻	hnp
𰐼	op
𰐽	hnip
𰐾	pi
𰐿	pnhh
𰑀	enp
𰑁	pqni
𰑂	pbk
𰑃	pa
𰑄	pop
𰑅	poo
𰑆	hqp
𰑇	phmd
𰑈	aup
𰑉	uep
𰑊	pqni
𰑋	ssp
𰑌	pbk
𰑍	prks
𰑎	ogp
𰑏	pjp
𰑐	ptmm
𰑑	csp
𰑒	php
𰑓	wtp
𰑔	qip
𰑔	qkp
𰑕	mikp
𰑖	poq
𰑗	phlk
𰑘	ptq
𰑙	pykn
𰑚	pjdi
𰑛	pihp
𰑜	ihsp
𰑝	pjbk
𰑞	pmjp
𰑟	mbop
𰑠	prd
𰑡	legp
𰑢	hshp
𰑣	hqrp
𰑤	pjki
𰑥	plsb
𰑦	pifm
𰑧	klp
𰑨	mup
𰑩	dip
𰑪	prlu
𰑫	pwln
𰑬	phjo
𰑭	hkp
𰑮	pysk
𰑯	piop
𰑰	pjds
𰑱	pmad
𰑲	gogp
𰑳	pjbl
𰑴	mlph
𰑵	tjbp
𰑶	ahqp
𰑷	nsp
𰑸	iktp
𰑹	ptbn
𰑺	pehr
𰑻	ytlp
𰑼	mfmp
𰑽	pfbc
𰑾	ptks
𰑿	pfbu
𰒀	psqf
𰒁	hfps
𰒂	puup
𰒃	ylp
𰒄	fjp
𰒅	pmzs
𰒆	ptmb
𰒇	pokb
𰒈	pydl
𰒉	pjse
𰒊	yjp
𰒋	pmrk
𰒌	sup
𰒍	gep
𰒎	pogd
𰒏	pcno
𰒐	ptgu
𰒐	ptqu
𰒑	ptxf
𰒒	ebp
𰒓	pnxu
𰒔	pqcs
𰒕	pwvi
𰒖	bop
𰒗	pjuu
𰒘	gegp
𰒙	petb
𰒚	ypmnr
𰒛	dep
𰒜	mphae
𰒝	dlph
𰒞	pvvv
𰒟	pmwb
𰒠	crwbp
𰒡	pmzr
𰒢	phwm
𰒣	jrrp
𰒤	mfi
𰒥	ii
𰒦	ihem
𰒧	inie
𰒨	viio
𰒩	iaj
𰒪	mti
𰒫	ipua
𰒬	yrooi
𰒭	ibcn
𰒮	ijdl
𰒯	sfi
𰒰	yri
𰒱	vdi
𰒲	irmr
𰒳	iibvk
𰒴	ishnk
𰒵	hsycr
𰒵	isycr
𰒶	hshss
𰒶	isiss
𰒷	qp
𰒸	qsl
𰒹	qps
𰒺	qsm
𰒻	qnn
𰒼	qmmm
𰒽	qms
𰒾	qnmn
𰒿	qsc
𰓀	qmvi
𰓁	qpp
𰓂	qi
𰓃	qke
𰓄	qpo
𰓅	hupq
𰓆	qhvm
𰓇	qino
𰓈	qis
𰓈	qhs
𰓉	ykq
𰓊	qksc
𰓋	qal
𰓌	qjl
𰓍	qtm
𰓎	qmnr
𰓏	qkr
𰓐	qlk
𰓑	qwl
𰓒	qlwu
𰓓	qou
𰓔	qlso
𰓕	qyk
𰓖	qlln
𰓗	qmgi
𰓘	qmhn
𰓙	mikq
𰓚	qknd
𰓛	inq
𰓜	qtsl
𰓝	qllb
𰓞	qhby
𰓟	qknd
𰓠	qomi
𰓡	qosk
𰓢	qtki
𰓣	qjni
𰓤	qiuj
𰓥	qihi
𰓦	qjcn
𰓧	qndf
𰓨	qed
𰓩	qnpd
𰓪	qlq
𰓫	qswl
𰓬	qmbb
𰓭	qmjp
𰓮	qndj
𰓯	qdl
𰓰	qkoo
𰓱	qleg
𰓲	rnq
𰓳	qhmb
𰓴	qpmi
𰓵	qhej
𰓶	hnq
𰓷	qlsg
𰓸	qhsr
𰓸	qisr
𰓹	qiti
𰓺	qsly
𰓻	qqou
𰓼	qkql
𰓽	qta
𰓾	qwlu
𰓿	qxpm
𰔀	qtop
𰔁	qhyf
𰔂	qlon
𰔃	qegi
𰔄	nzoq
𰔅	qmem
𰔆	qmws
𰔇	qtjb
𰔈	qjir
𰔉	qqmt
𰔊	qptd
𰔋	qlmo
𰔌	qtkr
𰔍	qhor
𰔎	qmke
𰔏	qjce
𰔐	qikf
𰔐	qbhf
𰔑	qneq
𰔒	qsly
𰔓	qmre
𰔔	qmnf
𰔕	geq
𰔖	qyhr
𰔗	qhlk
𰔘	qbss
𰔙	qhyhe
𰔚	qbni
𰔛	qfdj
𰔜	qywv
𰔝	qike
𰔞	qiqe
𰔟	qgli
𰔟	qglk
𰔠	qubu
𰔡	qwhr
𰔢	qcsc
𰔣	qonc
𰔤	qyku
𰔥	kiqmn
𰔦	qbbq
𰔧	qhmn
𰔨	qjce
𰔩	qiyt
𰔪	qddo
𰔫	qpuz
𰔬	qkcf
𰔭	qtgs
𰔮	qbwp
𰔯	qnbk
𰔰	qiod
𰔱	qytu
𰔲	qjtm
𰔳	qkoi
𰔴	qank
𰔵	qummi
𰔶	xcq
𰔷	qiwj
𰔸	qstp
𰔹	qhop
𰔺	qhsf
𰔻	qbbi
𰔼	qivf
𰔽	qtrg
𰔾	oqqao
𰔿	qwlg
𰕀	jevvv
𰕁	jesdi
𰕂	jeytr
𰕃	msye
𰕄	ikok
𰕅	skye
𰕆	yhsye
𰕇	itok
𰕈	hklok
𰕉	sokye
𰕊	bndok
𰕋	fbrye
𰕌	ogok
𰕍	ykl
𰕎	yibok
𰕏	moxok
𰕐	yboye
𰕑	omrok
𰕒	fbgye
𰕓	hahok
𰕔	orrok
𰕕	ytgok
𰕖	srgok
𰕗	buxok
𰕘	ypbye
𰕙	nbuok
𰕚	hmyk
𰕛	nhyk
𰕜	htyk
𰕝	ojhml
𰕞	hlyy
𰕟	sbhml
𰕠	yahml
𰕡	vrhml
𰕢	tthml
𰕣	rjhml
𰕤	xxhml
𰕥	rjohl
𰕦	taycl
𰕧	yslln
𰕨	ysluo
𰕩	ysfb
𰕪	ysbnd
𰕫	ysiav
𰕬	ysoaj
𰕭	ysooi
𰕮	ysoob
𰕯	yof
𰕰	llmu
𰕱	ams
𰕲	lla
𰕳	and
𰕴	ajp
𰕵	amks
𰕶	ahne
𰕷	aoll
𰕸	amx
𰕹	amjks
𰕺	aqni
𰕻	awl
𰕼	alwl
𰕽	wyia
𰕾	shna
𰕿	amcw
𰖀	ajng
𰖁	adb
𰖂	afs
𰖃	oooa
𰖄	ahpl
𰖅	ahgu
𰖆	nema
𰖇	ajru
𰖈	amlh
𰖉	amrt
𰖊	aajk
𰖋	aheo
𰖌	akhg
𰖍	adw
𰖎	asmv
𰖏	aykq
𰖐	amxm
𰖑	ayhl
𰖒	amka
𰖓	ajyk
𰖔	aea
𰖕	andt
𰖖	ambe
𰖗	ofda
𰖘	hra
𰖙	ayhh
𰖙	aykh
𰖚	afdv
𰖛	asqf
𰖜	ajid
𰖝	ahhw
𰖞	amedi
𰖟	aeiv
𰖠	aeog
𰖡	ampc
𰖢	agsk
𰖢	aqsk
𰖣	atmb
𰖤	afbb
𰖥	bva
𰖦	aabrs
𰖧	ayhj
𰖨	oamd
𰖩	ayub
𰖪	ayjr
𰖫	qkqb
𰖬	aydk
𰖭	atgu
𰖮	aruc
𰖮	arvc
𰖯	aykb
𰖰	aosje
𰖱	ayco
𰖱	ayto
𰖲	orra
𰖳	ampyk
𰖴	plh
𰖵	almt
𰖶	ahet
𰖷	ayav
𰖸	ajhw
𰖹	aagtl
𰖺	ajic
𰖻	aanw
𰖼	atwa
𰖽	ahuc
𰖾	aqki
𰖿	ahog
𰗀	cwma
𰗁	twjv
𰗂	laqmb
𰗃	canwa
𰗄	ycb
𰗅	blwu
𰗆	unb
𰗇	bhkn
𰗈	kbkb
𰗉	byrf
𰗊	bymr
𰗋	bbx
𰗌	bmpk
𰗍	bytj
𰗎	btkt
𰗏	kbggu
𰗐	qc
𰗑	ed
𰗒	de
𰗓	di
𰗔	mvhd
𰗕	bd
𰗖	dop
𰗗	donh
𰗘	lid
𰗙	dns
𰗚	dbym
𰗛	deq
𰗜	mikd
𰗝	djbm
𰗞	fsd
𰗟	duku
𰗠	dheb
𰗡	dyth
𰗢	dbkq
𰗣	yood
𰗤	djmd
𰗥	dyks
𰗦	dsoy
𰗧	ywd
𰗨	dadi
𰗩	wdhi
𰗪	rid
𰗫	drng
𰗬	dyhj
𰗭	ynzd
𰗮	djd
𰗯	dbcj
𰗰	dsud
𰗱	dyki
𰗲	dywe
𰗳	wdmg
𰗴	dhog
𰗵	djll
𰗶	dfw
𰗷	jcrd
𰗸	dnzo
𰗹	dlf
𰗺	djto
𰗻	dmlv
𰗼	dahm
𰗽	dayt
𰗾	dokd
𰗿	hnd
𰘀	dtjb
𰘁	dehu
𰘂	dfdk
𰘃	dnhz
𰘄	dnlv
𰘅	dvmr
𰘆	dnhd
𰘇	dmrb
𰘈	dtcq
𰘉	jdwmv
𰘊	wdmhp
𰘋	wdhau
𰘌	dcc
𰘍	doqb
𰘎	djnau
𰘏	deid
𰘏	dekd
𰘐	xpdk
𰘑	fjd
𰘒	tod
𰘓	tbdd
𰘔	difq
𰘔	dmfq
𰘕	dspe
𰘖	dtme
𰘗	dgsk
𰘗	dqsk
𰘘	ddyp
𰘙	dskhi
𰘚	dddt
𰘛	dbci
𰘜	dwhr
𰘝	dcsc
𰘞	kcdbm
𰘞	kddbm
𰘟	dhah
𰘠	dlsx
𰘡	yod
𰘢	djse
𰘣	dvmb
𰘤	sid
𰘥	ddbb
𰘦	jdyrj
𰘧	dgrv
𰘨	gud
𰘩	dtlf
𰘪	wdhss
𰘪	wdiss
𰘫	daqb
𰘬	wdonp
𰘭	xxxd
𰘮	dhkd
𰘮	dikd
𰘯	dvfr
𰘰	dnmn
𰘱	nnd
𰘲	dnlh
𰘳	ddlo
𰘴	dkcf
𰘵	dgrt
𰘶	dnmd
𰘷	djtg
𰘸	dfvk
𰘹	dioc
𰘹	dmoc
𰘺	dgdw
𰘻	dak
𰘼	kihed
𰘽	davf
𰘾	mrmrd
𰘿	datj
𰙀	danw
𰙁	wdtak
𰙂	vdmmu
𰙃	hiwd
𰙄	otdnd
𰙅	srd
𰙆	ddwnf
𰙇	dljul
𰙈	otdjd
𰙉	dtdtt
𰙊	knjno
𰙋	hvmno
𰙌	wsno
𰙍	gbino
𰙎	ofmno
𰙏	afno
𰙐	ybmno
𰙑	lfno
𰙒	ymdno
𰙓	osino
𰙔	bmrno
𰙕	fdvno
𰙖	qmwno
𰙗	bxno
𰙘	orbno
𰙙	yewno
𰙚	mnx
𰙛	mxmn
𰙜	shhx
𰙜	shix
𰙜	skx
𰙝	xmg
𰙞	xhg
𰙟	nhex
𰙠	mobx
𰙡	xjp
𰙢	dhex
𰙣	xrup
𰙤	mxmx
𰙥	xphe
𰙥	xpme
𰙦	jix
𰙧	rrx
𰙨	lgx
𰙩	shx
𰙪	ybmx
𰙫	xgl
𰙬	doox
𰙭	xog
𰙮	hwhx
𰙯	xxih
𰙰	xoav
𰙱	xjmg
𰙲	yblx
𰙳	nqx
𰙴	mrbx
𰙵	xyrb
𰙶	jtcx
𰙷	yjrx
𰙸	mxytj
𰙹	xvff
𰙺	hzx
𰙻	wgmdx
𰙼	mnmmm
𰙽	mnjbt
𰙾	mnomg
𰙿	mnxlh
𰙿	mnxnh
𰚀	mnyl
𰚁	mnytj
𰚂	mndlc
𰚃	gthne
𰚄	yfhne
𰚅	bjhne
𰚆	lvhne
𰚇	yrhne
𰚈	gmhne
𰚉	gbhne
𰚊	lwhne
𰚋	nrpps
𰚌	ppite
𰚍	hulis
𰚎	hupp
𰚏	mfhqu
𰚐	huki
𰚑	hucsh
𰚒	hulwl
𰚓	hulw
𰚔	jnhqu
𰚕	hushr
𰚖	tchqu
𰚗	tthqu
𰚘	hujbd
𰚙	hudt
𰚚	huomr
𰚛	hubdi
𰚜	hubnd
𰚝	huymr
𰚞	qbhqu
𰚟	huami
𰚠	jfhqu
𰚡	huyoj
𰚢	yrhqu
𰚣	huan
𰚤	mghqu
𰚥	hhmhu
𰚦	fvhqu
𰚧	husqf
𰚨	dshqu
𰚩	mihqu
𰚪	lthqu
𰚫	ybrhu
𰚬	hujoc
𰚭	skhqu
𰚮	nfhqu
𰚯	mfhqu
𰚰	dkhqu
𰚱	tthqu
𰚲	hufdc
𰚳	yzhu
𰚴	hujpn
𰚵	jmhqu
𰚶	sjhqu
𰚷	sug
𰚸	mirup
𰚹	lkrup
𰚺	jnhup
𰚻	onp
𰚼	onmmi
𰚽	onphh
𰚾	onjd
𰚿	onbu
𰛀	ongr
𰛁	onwm
𰛂	onnau
𰛃	oncsa
𰛄	nn
𰛅	no
𰛆	he
𰛇	edi
𰛈	eym
𰛉	elis
𰛊	esm
𰛋	edi
𰛌	eq
𰛌	eqi
𰛍	eke
𰛎	eqo
𰛏	eoo
𰛐	eno
𰛑	ejm
𰛒	ekd
𰛓	eqni
𰛔	eki
𰛕	jwe
𰛖	kce
𰛗	elmp
𰛘	elk
𰛙	bue
𰛚	ebbm
𰛚	ebt
𰛛	elso
𰛜	err
𰛝	eve
𰛞	emgs
𰛟	emcg
𰛠	emnp
𰛡	eppj
𰛢	eklg
𰛣	qie
𰛣	qke
𰛤	etsl
𰛥	eusu
𰛦	euni
𰛧	eymf
𰛨	enbo
𰛩	elsm
𰛪	yze
𰛫	eqll
𰛬	ejbk
𰛭	eppg
𰛮	eywk
𰛯	ehdn
𰛯	ehdu
𰛰	eokm
𰛱	eyhj
𰛲	eofm
𰛳	eok
𰛴	ehap
𰛵	elsd
𰛶	eysd
𰛷	efbf
𰛸	ejio
𰛹	eyvp
𰛺	enlb
𰛻	esf
𰛼	enib
𰛽	embo
𰛾	doe
𰛿	eyae
𰜀	exb
𰜁	eapp
𰜂	nehxe
𰜃	ebbr
𰜄	ehdh
𰜅	oue
𰜆	ebb
𰜇	eojk
𰜈	efw
𰜉	ffe
𰜊	ywre
𰜋	esie
𰜌	ejjh
𰜍	egrt
𰜎	edds
𰜏	emz
𰜐	eliu
𰜑	ethe
𰜒	elbt
𰜓	eyfi
𰜔	elma
𰜕	eabt
𰜖	ebbt
𰜗	errr
𰜘	eosd
𰜙	ebds
𰜚	egm
𰜛	eog
𰜜	eylc
𰜝	etol
𰜞	ejck
𰜟	eytr
𰜠	epav
𰜡	enlq
𰜢	ekro
𰜣	estq
𰜤	euog
𰜥	emml
𰜦	etmx
𰜧	eagr
𰜨	etkd
𰜩	ewkp
𰜪	elmu
𰜫	eyhr
𰜬	ehzu
𰜭	eomr
𰜮	eykj
𰜯	edks
𰜰	eelq
𰜱	eqla
𰜲	eqmw
𰜳	ebov
𰜴	ethj
𰜵	errw
𰜶	ehkr
𰜶	eikr
𰜷	ehnh
𰜸	eoyr
𰜹	ehhk
𰜺	ehyt
𰜻	ekha
𰜼	ejse
𰜽	eiot
𰜽	emot
𰜾	temb
𰜿	ejcd
𰝀	ecwe
𰝁	eanh
𰝂	eiif
𰝃	emzs
𰝄	efnh
𰝅	etbr
𰝆	elii
𰝇	eoog
𰝈	ejcc
𰝉	cae
𰝊	ehbu
𰝋	enlp
𰝌	enbnd
𰝍	essq
𰝎	evfn
𰝏	eang
𰝐	esmi
𰝑	ejij
𰝒	edrj
𰝓	eqbk
𰝔	eqor
𰝕	erwt
𰝖	ewbp
𰝗	ehla
𰝘	efuu
𰝙	eqhb
𰝚	embb
𰝛	ejlg
𰝜	emak
𰝝	emst
𰝞	ehlf
𰝟	enmq
𰝠	ejme
𰝡	ejvb
𰝢	eymu
𰝣	edor
𰝤	ealo
𰝥	efhk
𰝦	ehar
𰝧	ehud
𰝨	etbs
𰝩	eitf
𰝪	eqlrb
𰝫	esdf
𰝬	emzb
𰝭	etae
𰝮	eicr
𰝮	eidr
𰝯	eyrv
𰝰	emzw
𰝱	eyudk
𰝲	emws
𰝳	ebyp
𰝴	ejjs
𰝵	ecte
𰝶	fnn
𰝷	fm
𰝸	dhf
𰝹	fni
𰝺	fno
𰝻	hjf
𰝼	fnd
𰝽	ikuf
𰝾	fpo
𰝿	foj
𰞀	inof
𰞁	mobf
𰞂	bruf
𰞃	flmp
𰞄	lkf
𰞅	lwf
𰞆	lpv
𰞇	feq
𰞈	mfyj
𰞉	fmis
𰞊	ggf
𰞋	fkt
𰞌	fqhp
𰞍	ftsl
𰞎	obof
𰞏	fwdh
𰞐	hjdf
𰞑	fnau
𰞒	fnmu
𰞓	hegf
𰞔	fnir
𰞕	kif
𰞕	kkf
𰞖	kif
𰞖	kkf
𰞗	fknd
𰞘	hnf
𰞙	yckf
𰞚	ythf
𰞛	fimj
𰞜	nemf
𰞝	fss
𰞞	ssf
𰞟	qff
𰞠	qnf
𰞡	dlf
𰞢	fgpm
𰞣	fuon
𰞤	fleg
𰞥	fwf
𰞦	fokh
𰞧	bif
𰞨	psf
𰞩	fomd
𰞪	ffmhs
𰞫	shqf
𰞬	fshw
𰞭	fywk
𰞮	famk
𰞯	topf
𰞰	wrkf
𰞱	fypn
𰞱	fypu
𰞲	hewf
𰞳	fnwm
𰞴	lyf
𰞵	ffme
𰞶	jbmf
𰞷	fikh
𰞸	fsrl
𰞹	eef
𰞺	fmxk
𰞻	fjto
𰞼	qef
𰞽	dnef
𰞾	ftkr
𰞿	yif
𰟀	abuf
𰟁	foyr
𰟂	fuf
𰟃	fjkb
𰟄	flsr
𰟅	auf
𰟆	nrf
𰟇	qwf
𰟈	arf
𰟉	brf
𰟊	fbrf
𰟋	fwmmi
𰟌	wwyf
𰟍	fckn
𰟎	fftc
𰟏	fcmt
𰟏	ftct
𰟐	ftlm
𰟑	tcsyf
𰟒	fmwi
𰟓	ftlb
𰟔	fyhr
𰟕	fhoo
𰟖	fpko
𰟗	oaaf
𰟘	flsx
𰟙	ftzd
𰟚	glff
𰟛	ddf
𰟜	fmwg
𰟝	tsmf
𰟞	guf
𰟟	fang
𰟠	iff
𰟡	feah
𰟢	ffbu
𰟣	dhf
𰟤	fkcf
𰟥	kqff
𰟦	fwbp
𰟧	frij
𰟧	frji
𰟨	fxvv
𰟩	orrf
𰟪	fseo
𰟫	fanr
𰟬	fyed
𰟭	ffff
𰟮	ebf
𰟯	ffbrw
𰟰	fkma
𰟱	sof
𰟲	fjtu
𰟳	ygf
𰟴	qfdw
𰟵	fwfk
𰟶	kftbo
𰟷	hff
𰟸	fnlo
𰟹	noff
𰟺	fffd
𰟻	frrk
𰟼	homvi
𰟽	hiir
𰟾	bobe
𰟿	bbb
𰠀	brd
𰠁	dohlo
𰠂	bttq
𰠃	wrhlo
𰠄	byoj
𰠅	hoyzu
𰠆	bnib
𰠇	lsbe
𰠈	bldk
𰠉	brrj
𰠊	bvfj
𰠋	ckikp
𰠌	ckihi
𰠍	ckyfe
𰠎	vmhne
𰠏	vmee
𰠐	vmphh
𰠑	vmhqm
𰠒	vmhbr
𰠓	vmmbu
𰠔	vmrhg
𰠔	vmrmg
𰠕	vmiok
𰠖	vmyrb
𰠗	lmnd
𰠘	vmyod
𰠙	llhlo
𰠙	lshlo
𰠚	llyhs
𰠚	lsyhs
𰠛	llij
𰠛	lsij
𰠜	llph
𰠜	lsph
𰠝	llive
𰠝	lsive
𰠞	llmlk
𰠞	lsmlk
𰠟	llqmb
𰠟	lsqmb
𰠠	mhmy
𰠡	mhhqo
𰠢	mhgr
𰠣	vndh
𰠤	mhhgr
𰠤	mhhqr
𰠥	mhgwc
𰠦	hqe
𰠧	rhq
𰠨	shq
𰠩	hqje
𰠪	hqmsu
𰠫	hqbk
𰠬	hqndu
𰠭	hqjd
𰠮	hqike
𰠮	hqikk
𰠯	hqkm
𰠰	hqmf
𰠱	hqbk
𰠲	hqnom
𰠳	hqyg
𰠴	hqjpu
𰠵	hqiav
𰠶	hqpni
𰠷	hqle
𰠸	hqytr
𰠹	hqwli
𰠺	vhhq
𰠻	hqfdw
𰠼	hqlmc
𰠽	ndik
𰠾	khhj
𰠿	khcsh
𰡀	pmik
𰡁	khyc
𰡂	khqni
𰡃	khjd
𰡄	khys
𰡅	khki
𰡆	khbq
𰡇	khniy
𰡈	ikbm
𰡉	khml
𰡊	khhkl
𰡋	khbkq
𰡌	khhby
𰡍	khkk
𰡎	khdt
𰡏	khrob
𰡐	khrbo
𰡑	khyw
𰡒	khyl
𰡓	khmxm
𰡔	khkql
𰡕	khdhl
𰡖	khrbt
𰡗	khbmc
𰡘	khono
𰡙	khhua
𰡚	khhlo
𰡛	khobt
𰡜	khqmv
𰡝	khtbu
𰡞	khjto
𰡟	khbcn
𰡠	khite
𰡡	khwlr
𰡢	khbov
𰡣	khyrk
𰡤	khyrf
𰡥	khssa
𰡦	yrike
𰡧	rjik
𰡨	khwlv
𰡩	khtjl
𰡪	ickpr
𰡫	khfsf
𰡬	khfdj
𰡭	mgkn
𰡮	mfg
𰡯	mgi
𰡰	mgkq
𰡱	mgob
𰡲	ykmgi
𰡳	mioi
𰡴	mgmx
𰡵	mgys
𰡶	mgymy
𰡷	mglu
𰡸	hwmg
𰡹	mghwk
𰡺	mgqd
𰡻	mgyuk
𰡼	mgnhd
𰡽	mgqki
𰡾	mgbv
𰡿	mihnb
𰢀	mgnig
𰢁	mgomg
𰢂	mgbfd
𰢃	fbrmi
𰢄	mglf
𰢅	mgmrw
𰢆	mgoy
𰢇	mgof
𰢈	mghjg
𰢉	mgypk
𰢊	mimii
𰢋	mgsrr
𰢌	mgomf
𰢍	icmgi
𰢍	idmgi
𰢎	mghhd
𰢏	mgmbb
𰢐	mgxxx
𰢑	mgnwa
𰢒	nhmgi
𰢓	mgtwt
𰢔	mghav
𰢕	mgywd
𰢖	mgrsb
𰢗	mgatj
𰢘	mgicr
𰢘	mgidr
𰢙	mgorb
𰢚	mgsjj
𰢛	hluo
𰢜	hiou
𰢝	hoiav
𰢞	hoc
𰢟	hvhio
𰢠	hotyb
𰢡	xshio
𰢢	mumun
𰢣	mnkjt
𰢤	bomun
𰢥	mvmun
𰢦	fvmun
𰢧	tmp
𰢨	tmb
𰢩	tmqp
𰢪	tzino
𰢫	fhhm
𰢬	hmrms
𰢭	hmgr
𰢮	wghqm
𰢯	hmdwf
𰢰	phbq
𰢱	bqbq
𰢲	phbq
𰢳	nbhhn
𰢴	mw
𰢵	uw
𰢶	wms
𰢷	fw
𰢸	llw
𰢹	wmjj
𰢹	wmkj
𰢹	wmt
𰢺	wop
𰢻	lwphh
𰢼	whv
𰢽	wphh
𰢾	ywo
𰢿	wkr
𰣀	whqm
𰣁	wkr
𰣂	wlgb
𰣃	npw
𰣄	ytwl
𰣅	wyiw
𰣆	wlher
𰣇	hnvvw
𰣈	fbhw
𰣉	wsmg
𰣊	wske
𰣋	goow
𰣌	wscmk
𰣍	wytr
𰣎	wtcf
𰣏	wqke
𰣐	llafu
𰣑	wnzf
𰣒	hihhw
𰣒	mihhw
𰣓	hwphh
𰣔	wvtbs
𰣕	mwaa
𰣖	wwbbm
𰣗	hbkw
𰣘	fdw
𰣙	wnoe
𰣚	wnmr
𰣛	wscwa
𰣜	rwneq
𰣝	mwcwa
𰣞	wwmzw
𰣟	wwwww
𰣠	manyo
𰣡	yvwo
𰣢	kbk
𰣣	kl
𰣤	kby
𰣥	kokn
𰣦	kiks
𰣧	kksc
𰣨	kee
𰣩	kjmn
𰣪	kve
𰣫	kfmc
𰣬	kykl
𰣭	kav
𰣮	knbg
𰣯	klsa
𰣰	kfb
𰣱	mmlsy
𰣲	kfw
𰣳	knim
𰣴	kytv
𰣵	kumb
𰣶	klmo
𰣷	kbcn
𰣸	knup
𰣹	kbam
𰣺	kmob
𰣻	kmrr
𰣼	khdc
𰣽	kyzq
𰣾	krrw
𰣿	klip
𰤀	kbcu
𰤁	mmmrw
𰤂	kjjb
𰤃	kogf
𰤄	kooa
𰤅	mmtwb
𰤆	kmxw
𰤇	knbq
𰤈	kpwg
𰤉	kdmf
𰤊	mmnfq
𰤋	khdf
𰤌	nok
𰤍	non
𰤎	nonl
𰤏	nowu
𰤐	nomwm
𰤑	noysk
𰤒	hav
𰤓	hanhh
𰤔	havv
𰤕	hahvd
𰤖	haaj
𰤗	hayvo
𰤘	vdha
𰤙	qlha
𰤚	qoha
𰤛	ora
𰤜	bbha
𰤝	hattd
𰤞	dev
𰤟	degi
𰤠	rrdhe
𰤡	pudhe
𰤢	dehqm
𰤣	mgdhe
𰤤	bodhe
𰤥	hrdhe
𰤦	defd
𰤧	dess
𰤨	deyk
𰤩	dehdn
𰤪	judhe
𰤫	dejnk
𰤬	jkdhe
𰤭	kldhe
𰤮	aadhe
𰤯	tvdhe
𰤰	kudhe
𰤱	debbb
𰤲	btmn
𰤳	nibt
𰤴	nhbt
𰤵	hjbt
𰤶	kcbt
𰤷	wbt
𰤸	npbt
𰤹	eobt
𰤺	wlhut
𰤻	llbt
𰤼	aabt
𰤽	mqbt
𰤾	bbbt
𰤿	lubt
𰥀	bubt
𰥁	ttmf
𰥂	tton
𰥃	gebt
𰥄	ttsmr
𰥅	cthgu
𰥅	tthgu
𰥆	vlbt
𰥇	xcbt
𰥈	gtqal
𰥉	ybbt
𰥊	yobt
𰥋	busm
𰥌	bumy
𰥍	buk
𰥎	kbu
𰥏	bur
𰥐	ybum
𰥑	jbuy
𰥒	buoo
𰥓	buph
𰥔	buhk
𰥕	buqni
𰥖	qkbu
𰥗	buqmn
𰥘	lkbu
𰥙	umbu
𰥚	hdbu
𰥛	buill
𰥜	uubu
𰥝	bukf
𰥞	tbbu
𰥟	fupn
𰥠	yzbu
𰥡	jdiu
𰥢	bumbb
𰥣	buleg
𰥤	buav
𰥥	hebu
𰥦	buhoe
𰥧	bulmk
𰥨	bulsb
𰥩	busqi
𰥪	buqou
𰥫	busje
𰥬	butol
𰥭	burwu
𰥭	burlu
𰥮	buumj
𰥯	bucip
𰥰	hupi
𰥱	buoyo
𰥲	yvbu
𰥳	buiyr
𰥴	bueyt
𰥵	butlj
𰥶	hulk
𰥷	bujmr
𰥸	butod
𰥹	bufbu
𰥺	jmoos
𰥺	jvoos
𰥻	bujyl
𰥼	fkbu
𰥽	bullu
𰥾	gkbu
𰥿	butcu
𰥿	butcv
𰦀	bufbu
𰦁	bujff
𰦂	gebu
𰦃	buhhd
𰦄	bufbw
𰦅	buybj
𰦆	buffu
𰦇	buanj
𰦈	hucjj
𰦉	bugcu
𰦊	buhoe
𰦋	buhwi
𰦌	jcjcc
𰦍	nzf
𰦎	inzh
𰦏	nhik
𰦐	nhxp
𰦑	nhc
𰦒	oqo
𰦓	oky
𰦔	okbhu
𰦕	okdk
𰦖	okok
𰦗	okgug
𰦘	ormnr
𰦙	orsmr
𰦚	okxok
𰦛	okmtn
𰦜	okwli
𰦝	okkrb
𰦞	oktak
𰦟	okmxg
𰦠	pknbc
𰦡	otmk
𰦢	oknwa
𰦣	okdoo
𰦤	mrsli
𰦥	mrhe
𰦥	mrme
𰦦	mrmks
𰦧	mrmrm
𰦨	mriks
𰦩	mrhs
𰦩	mris
𰦪	mrsm
𰦫	mree
𰦬	mree
𰦭	mrikp
𰦮	mrkus
𰦯	mrymy
𰦰	mreq
𰦱	rupr
𰦲	mredi
𰦳	mrsj
𰦴	mrml
𰦵	mrkdi
𰦶	mrmam
𰦷	tbmr
𰦸	mraj
𰦹	mrx
𰦺	mrihi
𰦻	mrdhe
𰦼	mrjbd
𰦽	mrqme
𰦾	mrmlh
𰦿	mrrob
𰧀	mrat
𰧁	mrll
𰧂	ormr
𰧃	mrlsa
𰧄	mrykr
𰧅	mrdey
𰧆	mrkjt
𰧇	mrleo
𰧈	mrtkc
𰧉	mrhjo
𰧊	mrjll
𰧋	gbrok
𰧌	mrbn
𰧍	mrhqj
𰧎	mropo
𰧏	mrtbn
𰧐	mrmem
𰧐	mrnrm
𰧑	gkmr
𰧑	qkmr
𰧒	mrass
𰧓	mrtbd
𰧔	mrlit
𰧕	mroar
𰧖	mrkce
𰧖	mrkde
𰧗	mrhjg
𰧘	mriua
𰧙	mrfbg
𰧚	mrwfu
𰧛	mrumg
𰧜	mrusk
𰧝	mrcsc
𰧞	mrnwa
𰧟	mryyr
𰧠	simr
𰧡	mrmrw
𰧢	mrqoa
𰧣	tlmr
𰧤	mrhlq
𰧥	mrhgi
𰧦	mrooa
𰧧	mrtxf
𰧨	mrejd
𰧩	mrgzz
𰧪	mrqoc
𰧫	mrnri
𰧬	mrhkb
𰧭	gmmf
𰧮	ifml
𰧮	mfml
𰧯	ifmi
𰧯	mfmi
𰧰	ifnhh
𰧱	ifbmm
𰧱	mfbmm
𰧲	opmmf
𰧳	ifma
𰧳	mfma
𰧴	ifsno
𰧴	mfsno
𰧵	ifl
𰧵	mfl
𰧶	ifipm
𰧶	mfipm
𰧷	ifkn
𰧷	mfkn
𰧸	jimmf
𰧹	ifvr
𰧹	mfvr
𰧺	ifnin
𰧺	mfnin
𰧻	ifomi
𰧻	mfomi
𰧼	ifhkr
𰧼	mfhkr
𰧽	ifhbr
𰧽	mfhbr
𰧾	ifhbv
𰧾	mfhbv
𰧿	yamf
𰨀	ifmgt
𰨀	mfmgt
𰨁	ifgug
𰨁	mfgug
𰨂	ifomd
𰨂	mfomd
𰨃	ifoog
𰨃	mfoog
𰨄	ifwv
𰨄	mfwv
𰨅	iflsy
𰨅	mflsy
𰨆	ifvin
𰨆	mfvin
𰨇	ogmf
𰨈	ifioi
𰨈	mfioi
𰨉	ifjrr
𰨉	mfjrr
𰨊	ifyod
𰨊	mfyod
𰨋	ifbgb
𰨋	mfbgb
𰨌	ifytr
𰨌	mfytr
𰨍	ifneq
𰨍	mfneq
𰨎	ifhaw
𰨎	mfhaw
𰨏	ifnuw
𰨏	mfnuw
𰨐	ifmrb
𰨐	mfmrb
𰨑	ifmrw
𰨑	mfmrw
𰨒	ifjmc
𰨒	mfjmc
𰨓	mfruc
𰨓	ifruc
𰨓	mfruc
𰨓	mfrvc
𰨔	xmfmz
𰨕	ifayb
𰨕	mfayb
𰨖	ifaoo
𰨗	ifgrf
𰨗	mfgrf
𰨘	mfheg
𰨙	iftob
𰨙	mftob
𰨚	dmhb
𰨛	hdsh
𰨜	hdi
𰨝	hdhq
𰨞	hdknj
𰨟	hdmbm
𰨠	hdlk
𰨡	hdwl
𰨢	hdopd
𰨣	hdhfd
𰨤	hdsmr
𰨥	hdhgu
𰨦	hdykl
𰨧	hdyvu
𰨧	hdyvv
𰨨	hdss
𰨩	muhd
𰨪	hdgug
𰨫	hduau
𰨬	hdnla
𰨭	hdwv
𰨮	hfa
𰨯	hdhss
𰨯	hdiss
𰨰	hdhlb
𰨱	hdkrb
𰨲	hdhd
𰨳	hdioo
𰨴	hdhne
𰨵	jbhdn
𰨵	jbhdu
𰨶	hdyrd
𰨷	hdjpu
𰨸	hdqoa
𰨹	hgls
𰨺	hdjhb
𰨻	hdlx
𰨼	hdrxr
𰨽	hdeem
𰨾	hdkma
𰨿	hditf
𰩀	hdjqp
𰩁	hdtgs
𰩂	hdmji
𰩃	hdbug
𰩄	jcee
𰩅	jcikp
𰩆	jcsr
𰩇	jcnil
𰩈	jchd
𰩉	jcvis
𰩊	jcymf
𰩋	jcgug
𰩌	gijcs
𰩍	jcmp
𰩎	jcrau
𰩏	jched
𰩐	jckbm
𰩑	jcbmc
𰩒	jcyfe
𰩓	jcmxu
𰩔	jcgg
𰩕	nejcs
𰩖	jcav
𰩗	jctaj
𰩘	jcpag
𰩙	jctak
𰩚	jmmwv
𰩛	jcxpf
𰩜	jckcf
𰩝	jchse
𰩞	jcknk
𰩟	jhhgi
𰩠	xyt
𰩡	ytom
𰩢	ytqni
𰩣	ytod
𰩤	ytyck
𰩥	ytmbk
𰩦	ytabu
𰩧	hoyt
𰩨	ythg
𰩩	geyt
𰩪	ytwhr
𰩫	yuytu
𰩬	hk
𰩭	hu
𰩮	hqni
𰩯	hmlb
𰩰	hsmu
𰩱	hbmm
𰩲	hys
𰩳	hlwu
𰩳	hlwv
𰩴	hrhu
𰩵	hbq
𰩶	hhke
𰩷	hsmm
𰩸	hhkl
𰩹	henh
𰩺	hvmi
𰩻	hydi
𰩼	hmvm
𰩽	hmhio
𰩾	hrik
𰩿	hgpr
𰪀	hdw
𰪁	hlba
𰪂	hlsy
𰪃	hlsh
𰪄	hyks
𰪅	hmgt
𰪆	hqhr
𰪇	hzcsh
𰪈	hdbm
𰪉	hyrf
𰪊	hopl
𰪋	hkhi
𰪌	hbie
𰪍	hyta
𰪎	hybu
𰪏	hkqr
𰪐	hcks
𰪑	hoik
𰪒	ythip
𰪓	hbmo
𰪔	hiek
𰪕	hpmz
𰪖	hfog
𰪗	hddd
𰪘	hpkf
𰪙	hdqh
𰪙	hdqi
𰪙	hdqk
𰪚	hbug
𰪛	hlig
𰪜	hhys
𰪝	hanc
𰪞	hdtk
𰪟	hqtk
𰪠	hypb
𰪡	hhdw
𰪢	hvfb
𰪣	hyko
𰪣	hyno
𰪤	hhdl
𰪥	hcyo
𰪦	fdk
𰪧	fdt
𰪨	pfdv
𰪩	fdi
𰪪	fdsm
𰪫	fdqni
𰪬	fdmg
𰪭	fdpo
𰪮	fdht
𰪯	fdhg
𰪯	fdmg
𰪰	ahfd
𰪱	fdqni
𰪲	fdmnr
𰪳	fdmf
𰪴	fdwl
𰪵	fdhqo
𰪶	fdwdh
𰪷	fdfk
𰪸	fdkna
𰪹	fdoq
𰪺	fdhon
𰪻	fdkd
𰪼	fdyth
𰪽	fdhdn
𰪾	fdqkq
𰪿	fdtbs
𰫀	fdami
𰫁	fdkg
𰫂	fdlpb
𰫃	fdbjj
𰫄	fdxg
𰫅	fdehr
𰫆	fdsqf
𰫇	fdtor
𰫈	fdhjg
𰫉	fdjoc
𰫊	fdlne
𰫋	fdtmb
𰫌	fdnhu
𰫍	fdhgs
𰫎	fdyyr
𰫏	fdytm
𰫏	fdykm
𰫐	fdqkx
𰫑	fdydk
𰫒	fdjao
𰫓	fdcwa
𰫔	fdmwe
𰫕	fdyx
𰫖	fdtlw
𰫗	vfo
𰫘	vfyv
𰫙	vfnd
𰫚	vfmlb
𰫛	vfpi
𰫜	vfokn
𰫝	vfsk
𰫞	vfikp
𰫟	vfrms
𰫠	vfwl
𰫡	vfhqm
𰫢	vfkd
𰫣	vfsur
𰫤	vfav
𰫥	wfpn
𰫦	vioos
𰫧	vfjd
𰫨	vfirm
𰫩	vftop
𰫪	vfwlu
𰫫	vfwhy
𰫬	vfhbn
𰫭	vffve
𰫮	vfykh
𰫯	vfybu
𰫰	vfhsk
𰫱	sfon
𰫲	vfyyr
𰫳	vfgor
𰫴	vfwdt
𰫵	vfkma
𰫶	ovvif
𰫷	vfnwa
𰫸	vfjqp
𰫹	vfmd
𰫺	vavif
𰫻	tovif
𰫼	vmmn
𰫽	vmmf
𰫾	vmmmu
𰫿	vml
𰬀	vmoll
𰬁	vmis
𰬂	vmmnr
𰬃	vmmob
𰬄	vmmw
𰬅	vmodi
𰬆	vmpr
𰬇	vmyg
𰬈	vmyvi
𰬉	vmjp
𰬊	vmtmm
𰬋	vmni
𰬌	vmmbm
𰬍	vmkt
𰬎	vmppj
𰬏	vmhjd
𰬐	vmhkl
𰬑	vmnsd
𰬒	vmimo
𰬓	vmyvo
𰬔	vmtt
𰬕	vmfv
𰬖	vmihs
𰬗	vmije
𰬘	vmjbd
𰬙	vmmmv
𰬚	vmrbo
𰬛	vmbs
𰬜	vmnau
𰬝	vmlsa
𰬞	vmsbe
𰬟	vmirm
𰬠	vmmuw
𰬡	vmjlo
𰬢	vmjlv
𰬣	vmaph
𰬤	vmhwj
𰬥	vmcip
𰬦	vmphp
𰬧	vmff
𰬨	vmndt
𰬩	vmlf
𰬪	vmikh
𰬫	vmmgk
𰬬	vmtw
𰬭	vmggi
𰬮	vmkbq
𰬯	vmuce
𰬰	vmpkp
𰬱	vmjbf
𰬲	vmmhf
𰬳	vmytu
𰬴	vmjyl
𰬵	vmyso
𰬶	vmssa
𰬷	vmtbk
𰬸	vmjwp
𰬹	vmogs
𰬺	vmtwi
𰬻	vmnzb
𰬼	vmdlo
𰬽	vmnbq
𰬾	vmitc
𰬿	vmolo
𰭀	vmmbe
𰭁	vmthp
𰭂	ouc
𰭃	oue
𰭄	ouwjo
𰭅	ouile
𰭆	outog
𰭇	ouwww
𰭈	wlye
𰭉	bcrhu
𰭊	bodn
𰭋	wljm
𰭌	wltl
𰭍	bonau
𰭍	boshu
𰭎	wlyl
𰭏	boim
𰭐	bcbmc
𰭑	wlegi
𰭒	bkbo
𰭓	bkvfu
𰭔	wlvb
𰭕	bovfm
𰭖	bkvff
𰭗	tqhn
𰭘	tgbo
𰭙	tqhh
𰭙	tqtt
𰭚	tqfdv
𰭛	tkije
𰭜	tqbu
𰭝	ssm
𰭞	ssmml
𰭟	ness
𰭠	ssso
𰭡	ssike
𰭢	sskt
𰭣	qiss
𰭤	ahss
𰭥	ssikm
𰭦	hsjz
𰭧	qp
𰭨	qmd
𰭩	kqp
𰭪	wyqp
𰭫	qpryk
𰭬	gmbl
𰭭	ubos
𰭮	ubbm
𰭯	aumbl
𰭰	hdht
𰭱	qdoll
𰭲	qdwll
𰭳	sjhi
𰭴	sjiku
𰭵	sjmys
𰭶	cksj
𰭷	sjoj
𰭸	mlsj
𰭹	sjikp
𰭺	vesj
𰭻	sjmbb
𰭼	lqv
𰭽	lqa
𰭾	obu
𰭿	kboo
𰮀	cobo
𰮁	bsh
𰮂	oboks
𰮃	bf
𰮄	robo
𰮅	bvv
𰮆	obru
𰮇	bmku
𰮈	objb
𰮉	obmf
𰮊	bhq
𰮋	bchn
𰮌	peb
𰮍	kkob
𰮎	ukob
𰮏	obhne
𰮐	bbhn
𰮑	yiob
𰮒	bss
𰮓	bipm
𰮔	lpobo
𰮕	tmob
𰮖	obmx
𰮗	yrb
𰮘	obbm
𰮙	bns
𰮚	bnhf
𰮛	obhqm
𰮜	obir
𰮝	bjpu
𰮞	obkq
𰮟	bkq
𰮠	bkki
𰮡	bbc
𰮢	pukb
𰮣	obnau
𰮤	bfqo
𰮥	bgug
𰮦	bgi
𰮧	bomdr
𰮨	feub
𰮩	bkhk
𰮪	obbnd
𰮫	ddobo
𰮬	bbmc
𰮭	brwu
𰮭	brlu
𰮮	obtbs
𰮯	bhss
𰮯	biss
𰮰	byhl
𰮱	bphb
𰮲	blf
𰮳	bndt
𰮴	nlpb
𰮵	bgyvo
𰮶	jbobo
𰮷	btkr
𰮸	bbcn
𰮹	blfq
𰮺	blmb
𰮻	obxo
𰮼	bnrp
𰮽	bhda
𰮾	bjfe
𰮿	budhe
𰯀	bune
𰯁	bmki
𰯂	blit
𰯃	buhj
𰯄	brrb
𰯅	btpa
𰯆	obrrb
𰯇	hmwb
𰯇	hywb
𰯈	bfq
𰯉	bykj
𰯊	bnzf
𰯋	egobo
𰯌	bkop
𰯍	bmzu
𰯎	btmb
𰯏	btmd
𰯐	bnwa
𰯑	bile
𰯒	bsso
𰯓	bsne
𰯔	bmjk
𰯔	bnjk
𰯕	bjwp
𰯖	mtob
𰯗	bfbq
𰯘	bnw
𰯙	bfgg
𰯚	bfff
𰯛	byzi
𰯜	hbpha
𰯜	ibpha
𰯝	bshx
𰯝	bsix
𰯝	bsxx
𰯞	bwll
𰯟	bnlb
𰯠	igobo
𰯡	bteb
𰯢	buykr
𰯣	objac
𰯤	bana
𰯥	ooobo
𰯦	objtu
𰯧	bitf
𰯨	bywv
𰯩	byrg
𰯪	bsse
𰯫	biho
𰯬	bwwf
𰯭	ninib
𰯮	sys
𰯯	slhne
𰯰	slre
𰯱	sehml
𰯲	slomw
𰯳	slsbb
𰯴	hulb
𰯵	hulln
𰯶	htmj
𰯷	hkahm
𰯸	xdd
𰯹	xwd
𰯺	xskn
𰯻	hxneq
𰯻	mxneq
𰯼	xbta
𰯽	hrymy
𰯾	hrph
𰯾	mrph
𰯿	hrdhe
𰯿	mrdhe
𰰀	hrwk
𰰁	hrrr
𰰁	mrrhr
𰰂	osomr
𰰃	hrnau
𰰃	mrnau
𰰄	hrsf
𰰄	mrsf
𰰅	hrshp
𰰅	hrskp
𰰅	mrshp
𰰅	mrskp
𰰆	hrcwj
𰰇	hrmwg
𰰇	mrmwg
𰰈	hrbmo
𰰈	mrbmo
𰰉	hrors
𰰊	sfnq
𰰋	hyee
𰰌	hyns
𰰍	hycme
𰰎	jjhby
𰰏	hytjb
𰰐	hytoi
𰰑	hyfdv
𰰒	hymgg
𰰓	hyyog
𰰔	biav
𰰕	hnau
𰰖	nuyt
𰰗	nujmn
𰰘	ornau
𰰙	hgnau
𰰚	nuyzp
𰰛	nuwff
𰰜	tj
𰰝	tk
𰰞	uuk
𰰟	tpn
𰰠	tysm
𰰡	tbm
𰰢	tnhh
𰰣	tnl
𰰤	tsk
𰰥	tuu
𰰦	tfh
𰰧	thv
𰰨	top
𰰩	tyj
𰰪	tng
𰰫	tqni
𰰬	tmf
𰰭	tre
𰰮	tlis
𰰮	tlls
𰰯	tohs
𰰰	tkhu
𰰱	tedi
𰰲	tiln
𰰳	tllb
𰰴	tusu
𰰵	tkd
𰰶	tknd
𰰷	tnbo
𰰸	ten
𰰹	tykn
𰰺	tiue
𰰻	tes
𰰼	temy
𰰽	tbop
𰰾	tydi
𰰿	tkkq
𰱀	tmbo
𰱁	tjru
𰱂	tmgt
𰱃	tsok
𰱄	tvmv
𰱅	trd
𰱆	thqg
𰱇	tlsb
𰱈	tbmf
𰱉	tlsp
𰱊	tifm
𰱋	tnok
𰱌	tvmb
𰱍	tvmh
𰱎	tndk
𰱏	tta
𰱐	tjnk
𰱑	tkql
𰱒	ttd
𰱓	tdyn
𰱔	txb
𰱕	hatmd
𰱖	thog
𰱗	tlsh
𰱘	tfhl
𰱙	tfpi
𰱚	tfbd
𰱛	tvmm
𰱛	tvmy
𰱜	tnok
𰱝	tmmo
𰱞	tmxk
𰱟	tjto
𰱠	tgsm
𰱡	ttmo
𰱢	tlma
𰱣	trhb
𰱤	tobo
𰱥	tirp
𰱦	toae
𰱧	thdn
𰱨	tfmx
𰱩	tlsr
𰱪	tynv
𰱫	tmwi
𰱬	tqfb
𰱭	tpcu
𰱮	typp
𰱯	twli
𰱰	tjfh
𰱱	tioo
𰱲	tsjc
𰱳	tqta
𰱴	qotak
𰱵	tjow
𰱶	tsep
𰱷	dotop
𰱸	tsef
𰱹	trru
𰱺	tors
𰱻	thdv
𰱼	tybr
𰱽	tdcw
𰱾	tdlo
𰱿	tymw
𰲀	takg
𰲁	thno
𰲂	tbfm
𰲃	togt
𰲄	tyls
𰲅	tykm
𰲆	tejr
𰲇	tvrt
𰲈	tybk
𰲉	tesr
𰲊	tsro
𰲋	ttive
𰲌	tdbe
𰲍	tjqka
𰲎	tdije
𰲏	tyrq
𰲐	atic
𰲐	atid
𰲑	tofol
𰲒	tfko
𰲓	thls
𰲔	trxb
𰲕	thye
𰲖	trrr
𰲗	tdlm
𰲘	ynp
𰲘	yup
𰲙	ypoll
𰲚	hypo
𰲛	yphnr
𰲜	ynmu
𰲝	hypb
𰲞	yni
𰲞	yui
𰲟	ynhvm
𰲟	yuhvm
𰲠	ijypn
𰲠	ijypu
𰲢	yponr
𰲣	ypskr
𰲤	ypkl
𰲥	twypn
𰲥	twypu
𰲦	ynli
𰲦	yuli
𰲧	ypppa
𰲨	rdypn
𰲨	rdypu
𰲩	likn
𰲪	lihi
𰲫	limku
𰲬	likq
𰲭	ali
𰲮	leli
𰲯	lioo
𰲰	liop
𰲱	yhsi
𰲲	liiks
𰲳	liij
𰲴	ikpi
𰲵	lieq
𰲶	linom
𰲷	linyo
𰲸	mlli
𰲹	liusu
𰲺	liydi
𰲻	liyk
𰲼	liamj
𰲽	litbm
𰲾	linbg
𰲾	linbq
𰲿	liymf
𰳀	mbli
𰳁	liqmo
𰳂	likql
𰳃	lidf
𰳄	ndli
𰳅	lixb
𰳆	lixuo
𰳇	lifbg
𰳈	lijbm
𰳉	linnf
𰳊	lijto
𰳋	mhli
𰳌	liylw
𰳍	lifdk
𰳎	ggli
𰳏	lifbu
𰳐	xlii
𰳑	ohli
𰳒	hwhi
𰳓	liifu
𰳔	liibp
𰳕	liviv
𰳖	mnri
𰳗	libov
𰳘	liumg
𰳙	litgt
𰳚	vgli
𰳛	lihdk
𰳜	linbg
𰳝	fbfi
𰳞	licbo
𰳟	liknz
𰳠	linkf
𰳡	liyll
𰳢	norli
𰳣	vkli
𰳤	guliy
𰳥	litpp
𰳦	lijrz
𰳧	ihhbt
𰳨	hbmnn
𰳩	htdoi
𰳩	htdoe
𰳪	hovfn
𰳫	hobcn
𰳬	hoxhn
𰳭	hovxn
𰳮	hoxsn
𰳯	hoxln
𰳰	lp
𰳱	lyc
𰳲	likp
𰳳	kbyhv
𰳴	loip
𰳵	ltn
𰳶	lise
𰳷	lksr
𰳸	ledi
𰳹	lmik
𰳺	lhbv
𰳻	lyk
𰳼	lmbb
𰳽	lqnd
𰳾	lbms
𰳿	lbv
𰴀	lomc
𰴁	lthk
𰴂	likh
𰴃	lyrw
𰴄	ltge
𰴅	ldew
𰴆	dqyhv
𰴇	lfbg
𰴈	loyk
𰴉	ljqp
𰴊	lbut
𰴋	mgkn
𰴌	mvpdk
𰴍	mvltd
𰴎	lkbuu
𰴏	bupr
𰴐	hobuu
𰴑	buhkr
𰴒	mbbuu
𰴓	jcbuu
𰴔	lgbuu
𰴕	phbhu
𰴖	srbhu
𰴗	mbbhu
𰴘	lsbhu
𰴙	srbhu
𰴚	fvbhu
𰴛	rmbhu
𰴜	ymbhu
𰴝	bbbhu
𰴞	ytbhu
𰴟	shb
𰴠	nbe
𰴡	nbqt
𰴢	nbhvd
𰴣	fbnbg
𰴣	fbnbq
𰴤	nbdt
𰴥	nblsa
𰴦	nbana
𰴧	nymr
𰴨	iymr
𰴩	yrsh
𰴪	mfyr
𰴫	yrjd
𰴬	ynymr
𰴭	mwymr
𰴮	yrmam
𰴯	tbyr
𰴰	yrrr
𰴱	byre
𰴲	yrtu
𰴳	yrjf
𰴴	jvyr
𰴵	yrykm
𰴶	yrnem
𰴷	yrvie
𰴸	eoymr
𰴹	yrleg
𰴺	yrjd
𰴻	yrlsp
𰴼	yrbmc
𰴽	yrfsu
𰴾	yrmih
𰴿	woymr
𰵀	yrpyr
𰵁	yrkhv
𰵂	yrfdv
𰵃	yrytu
𰵄	yreog
𰵅	yrjff
𰵆	yrrru
𰵇	yrogs
𰵈	yrhgi
𰵉	yrtbn
𰵊	iuv
𰵋	iuhj
𰵌	iunhh
𰵍	iupu
𰵎	iuiku
𰵏	iufh
𰵐	iuhe
𰵑	iuiks
𰵒	iulbu
𰵓	iuid
𰵔	iupt
𰵕	iuqni
𰵖	iutn
𰵗	iulbk
𰵘	iugb
𰵙	iuhqo
𰵚	iuoni
𰵛	iupr
𰵜	iupru
𰵝	iuhd
𰵞	iuise
𰵟	iutmm
𰵠	iuve
𰵡	iunom
𰵢	iukt
𰵣	iuor
𰵤	iuher
𰵥	iunin
𰵦	iuyck
𰵧	iugp
𰵨	iumlh
𰵩	iuijb
𰵪	iubcr
𰵫	iumrt
𰵬	iurkn
𰵭	iuhdn
𰵮	iuhqi
𰵯	iuice
𰵰	iugl
𰵱	iudd
𰵲	iutz
𰵳	iuyaj
𰵴	iuyfe
𰵵	iuxhu
𰵶	iuhjm
𰵷	iueee
𰵸	iuea
𰵹	iusje
𰵺	iumhf
𰵻	iutks
𰵼	iunqd
𰵽	iubx
𰵾	iubvk
𰵿	iuyrb
𰶀	iumzs
𰶁	iuhdn
𰶂	iuhwp
𰶃	iussa
𰶄	iukqa
𰶅	iuhuj
𰶆	iusjk
𰶇	iunlb
𰶈	iuseq
𰶉	iuywm
𰶊	iuytp
𰶋	iujtu
𰶌	iumzb
𰶍	iunbe
𰶎	iusxx
𰶏	iuorb
𰶐	ocor
𰶑	crikp
𰶒	pucor
𰶓	crmnn
𰶔	crjnk
𰶕	croyk
𰶖	jrcor
𰶗	mrts
𰶘	qomrt
𰶙	mtmf
𰶚	hkmrt
𰶛	oikt
𰶜	mtjmu
𰶝	lymrt
𰶞	mtjid
𰶟	gemrt
𰶠	mtqal
𰶡	mtmrw
𰶢	mtdup
𰶣	ttvvu
𰶤	mop
𰶥	mosl
𰶦	mook
𰶧	msoe
𰶨	mobbu
𰶩	fsho
𰶪	modam
𰶪	modbm
𰶫	motoi
𰶫	motol
𰶬	mofdv
𰶭	monlb
𰶮	mohoo
𰶯	nodd
𰶰	momzo
𰶱	jbuc
𰶲	yvbc
𰶳	ppbuc
𰶴	bcgi
𰶵	xbuc
𰶶	phhc
𰶷	bucno
𰶸	inoc
𰶹	bcyk
𰶺	icsm
𰶻	bcnl
𰶼	bcw
𰶽	bclk
𰶾	bconi
𰶾	bcosl
𰶿	bcjp
𰷀	bcsj
𰷁	bcfs
𰷂	bcnin
𰷃	uubuc
𰷄	omgc
𰷅	bchrr
𰷅	bcmrr
𰷆	mkbuc
𰷇	bcomu
𰷈	bcpfd
𰷉	bcmws
𰷊	bcjid
𰷋	bctct
𰷌	jtlc
𰷍	imrc
𰷎	gebuc
𰷏	bcmge
𰷐	nabuc
𰷑	bcgrv
𰷒	lcomc
𰷓	lcojz
𰷔	olgwc
𰷕	jmcsc
𰷖	bctxf
𰷗	bcufe
𰷘	bcgzz
𰷙	aanbc
𰷚	bcjac
𰷛	bcitf
𰷜	bcnmr
𰷝	yhbuc
𰷞	ipbo
𰷟	bonhh
𰷠	bopd
𰷡	bommu
𰷢	bohui
𰷣	qobo
𰷤	boyoj
𰷥	jmmb
𰷦	millo
𰷧	lmfo
𰷨	bohwi
𰷩	bofbo
𰷪	botct
𰷫	boikk
𰷬	boitc
𰷭	boihs
𰷮	ynbo
𰷮	yubo
𰷯	bmrz
𰷰	gzffr
𰷱	goysm
𰷲	golll
𰷲	golls
𰷳	hobm
𰷴	gohvd
𰷵	gojpu
𰷶	gohkl
𰷷	gohso
𰷸	gojnk
𰷹	godd
𰷺	goybc
𰷻	hojbc
𰷻	hopbc
𰷼	gokrb
𰷽	gonuw
𰷾	gomgk
𰷿	hohkb
𰸀	gomzi
𰸀	gomzl
𰸁	rxsh
𰸂	rxk
𰸃	rxno
𰸄	rxnhh
𰸅	rxye
𰸆	rxyc
𰸇	rxee
𰸈	qiryo
𰸈	qkryo
𰸉	rxkmd
𰸊	rxuni
𰸋	rxhmr
𰸌	rxbln
𰸍	oxro
𰸎	rxyth
𰸏	ioryo
𰸏	moryo
𰸐	rxmbb
𰸑	rxjru
𰸒	rxnla
𰸓	rxife
𰸔	rxykq
𰸕	rxxb
𰸖	rxahl
𰸗	rxbfd
𰸘	rxpeg
𰸙	rxikh
𰸚	rxtjb
𰸛	tjbo
𰸜	rxtmd
𰸝	rxtcs
𰸞	rxlmo
𰸟	rxew
𰸠	rxbcn
𰸡	rxort
𰸢	rxmke
𰸣	rxnsp
𰸤	rxnay
𰸥	rxybn
𰸦	rxkro
𰸧	rxnzm
𰸨	rxtfd
𰸩	rxylo
𰸪	rxhoi
𰸫	rxgth
𰸬	rxqao
𰸭	rxbcr
𰸮	rxamg
𰸯	rxbaa
𰸰	rxxmz
𰸱	rxbot
𰸲	rxhal
𰸲	rxhhl
𰸳	rxtoe
𰸴	rxpko
𰸵	rxolz
𰸶	rxooo
𰸷	ulryo
𰸸	rxhxb
𰸹	rxtld
𰸺	hhhe
𰸺	hhme
𰸻	hhpn
𰸼	hhhqo
𰸽	hhph
𰸾	hhami
𰸿	hhwln
𰹀	hhfwj
𰹁	hhmfx
𰹂	hhtpr
𰹃	hhtkr
𰹄	hhumb
𰹅	hhhqj
𰹆	hhbbe
𰹇	hhthv
𰹈	jjn
𰹉	jwjs
𰹊	jjhp
𰹋	jjpi
𰹋	jjpm
𰹌	ycjwj
𰹍	jjjz
𰹎	jjhbo
𰹏	jjnil
𰹐	jjksr
𰹑	jjya
𰹒	jjse
𰹓	jjirm
𰹔	jjad
𰹕	jjrer
𰹖	jjhdl
𰹗	jjbmi
𰹘	jjbbe
𰹙	jjpmx
𰹚	jjeeo
𰹛	jjhdt
𰹜	jjuke
𰹝	jjytr
𰹞	iiij
𰹟	jjlmw
𰹠	jjogh
𰹡	jjren
𰹢	jjnzf
𰹣	jjnlp
𰹤	jjmrw
𰹥	jjaws
𰹦	jjhhc
𰹧	jjlx
𰹨	jjyub
𰹩	jjjfc
𰹪	jjicf
𰹫	vfu
𰹬	jjtis
𰹭	jjhgk
𰹮	jjtaf
𰹯	kqn
𰹰	kqo
𰹱	kqsu
𰹲	kqr
𰹳	kqlll
𰹴	kqhni
𰹵	kqik
𰹶	kqmg
𰹷	kqmmu
𰹸	kqpu
𰹹	kqpsh
𰹺	kqme
𰹺	kqhe
𰹻	kqau
𰹼	kqij
𰹽	kqmfj
𰹾	likq
𰹿	kqodi
𰺀	kqhui
𰺁	kqpr
𰺂	kqpru
𰺂	kqpsu
𰺃	kqedi
𰺄	kqtc
𰺅	tckq
𰺆	kqpa
𰺇	kqjmu
𰺈	kqskr
𰺉	kqqmb
𰺊	kqgce
𰺋	kqsje
𰺌	kqjnk
𰺍	kqwd
𰺎	kqlsy
𰺏	kqbb
𰺐	kqnx
𰺑	kqjnu
𰺒	kqumb
𰺓	kqoae
𰺔	kquce
𰺕	kqite
𰺖	kqqkd
𰺗	kqlit
𰺘	gekq
𰺙	kqgcw
𰺚	kqmbb
𰺛	kqkcf
𰺜	kqhfw
𰺝	kqytg
𰺞	kqsnd
𰺟	jekq
𰺠	kqjbk
𰺡	kqtgt
𰺢	kqmrr
𰺣	kqtlg
𰺤	kqhus
𰺥	ylkni
𰺥	ylknk
𰺦	ylnlo
𰺧	huyl
𰺨	ylmuw
𰺩	ylihr
𰺪	ylbo
𰺫	yltxf
𰺬	mbyl
𰺭	mvomi
𰺮	hoy
𰺯	yt
𰺰	ymu
𰺱	ylb
𰺲	ynhh
𰺳	yn
𰺴	ysc
𰺵	hox
𰺶	yhio
𰺷	yjpu
𰺸	yqhp
𰺹	ywdh
𰺺	yhhv
𰺻	ygp
𰺼	hxmso
𰺽	yiav
𰺾	yklu
𰺿	yjwi
𰻀	yggy
𰻁	ytbc
𰻂	yaf
𰻃	ybbe
𰻄	yhqb
𰻅	yytr
𰻆	ytjb
𰻇	yoae
𰻈	hohjg
𰻉	yorp
𰻊	yysb
𰻊	yyrb
𰻋	yfdl
𰻌	ylje
𰻍	ytlq
𰻎	ydog
𰻏	yuob
𰻐	ywtj
𰻑	yorr
𰻒	ykrr
𰻓	ytyhj
𰻔	yysq
𰻕	ylx
𰻖	mtyfd
𰻗	ytgq
𰻘	yhbk
𰻙	ylptd
𰻚	yskq
𰻛	ymoa
𰻜	yysf
𰻝	yjcp
𰻞	yjcp
𰻟	hinl
𰻠	runl
𰻡	mkunl
𰻢	mysnl
𰻣	purau
𰻤	xnl
𰻥	opnl
𰻦	iksnl
𰻧	jrru
𰻨	kdnl
𰻩	uurau
𰻪	qlbnl
𰻫	pwnl
𰻬	jmunl
𰻭	hddnl
𰻮	hydnl
𰻯	yrfnl
𰻰	sginl
𰻱	nrrau
𰻲	sugnl
𰻳	llnnl
𰻴	mgwnl
𰻵	wlunl
𰻶	uybnl
𰻷	herau
𰻷	ierau
𰻸	slav
𰻹	nwanl
𰻺	jpunl
𰻻	jffnl
𰻼	ddanl
𰻽	iwbnl
𰻾	wlvnl
𰻿	hhrau
𰼀	huanl
𰼁	ydqau
𰼂	mzrnl
𰼃	mbym
𰼄	mwht
𰼅	mweq
𰼆	vemcw
𰼇	mwjce
𰼈	mwsql
𰼉	mwife
𰼊	mwirm
𰼋	mwtbs
𰼌	mwlsy
𰼍	cwivi
𰼎	mwice
𰼏	mwlit
𰼐	mwkbt
𰼑	mwtmb
𰼒	mwlyd
𰼓	mwqoa
𰼔	mwvfr
𰼕	mwmwi
𰼖	mwjhw
𰼗	hdtt
𰼘	wgs
𰼙	wgpim
𰼙	wgpmm
𰼚	qkmwg
𰼛	dswg
𰼜	hgsbe
𰼝	wgyta
𰼞	hgc
𰼟	cr
𰼠	cno
𰼡	cshc
𰼢	cck
𰼣	cjm
𰼤	cdj
𰼥	cys
𰼦	cive
𰼧	cmam
𰼨	cfk
𰼩	npc
𰼪	iqc
𰼫	iiic
𰼬	cnem
𰼭	cydi
𰼮	cwd
𰼯	comx
𰼰	cnbg
𰼰	cnbq
𰼱	chaj
𰼲	cpw
𰼳	cofm
𰼴	csql
𰼵	mic
𰼶	dnc
𰼷	qtc
𰼸	cayk
𰼹	cwhy
𰼺	cwt
𰼻	kmc
𰼼	cudj
𰼽	duc
𰼾	clwb
𰼿	chmg
𰽀	corn
𰽁	cjrk
𰽂	cyhq
𰽃	ceob
𰽄	cfhf
𰽅	cyub
𰽆	cjbp
𰽇	cqao
𰽈	mzc
𰽉	cayc
𰽊	cmnv
𰽋	cjao
𰽌	cyfu
𰽍	cywb
𰽎	csfe
𰽏	cteb
𰽐	cfba
𰽑	ylcyl
𰽒	cnbe
𰽓	cxbu
𰽔	cucuu
𰽕	ophn
𰽖	opks
𰽗	opmd
𰽘	opk
𰽙	opym
𰽚	opi
𰽛	opf
𰽜	opsk
𰽝	opmks
𰽞	opmsu
𰽟	optt
𰽠	opx
𰽡	opa
𰽢	opbhu
𰽣	opnl
𰽤	opdk
𰽥	opmob
𰽦	opikp
𰽧	opmfm
𰽨	oprc
𰽩	opymy
𰽪	opom
𰽫	ophqm
𰽬	ophd
𰽭	oppr
𰽮	opodi
𰽯	opyg
𰽰	opfq
𰽱	oplln
𰽲	opgr
𰽳	opmbo
𰽴	opkms
𰽵	opfmu
𰽶	opli
𰽷	opuni
𰽸	ophhv
𰽹	opnin
𰽺	opnmu
𰽻	opohg
𰽻	opomg
𰽼	optt
𰽽	optq
𰽾	opydi
𰽿	opsju
𰾀	opjbd
𰾁	opme
𰾂	opjbk
𰾃	opryo
𰾄	opowy
𰾅	oponr
𰾆	opcor
𰾇	opmkr
𰾈	opefh
𰾉	opbcj
𰾊	ophwe
𰾋	opikq
𰾌	opkql
𰾍	opqmv
𰾎	ophwj
𰾏	oppou
𰾐	oplsy
𰾑	opc
𰾒	opjrr
𰾓	opea
𰾔	opihg
𰾕	opptd
𰾖	opkmb
𰾗	opihr
𰾘	optzv
𰾙	opwib
𰾚	opwmv
𰾛	opwcl
𰾛	opwol
𰾜	opumb
𰾝	opahm
𰾞	opuce
𰾟	opoae
𰾠	opnay
𰾡	oppyr
𰾢	opysd
𰾣	opsmg
𰾤	oprse
𰾥	opnok
𰾦	oprmo
𰾧	opqsk
𰾨	optgb
𰾩	opgit
𰾪	opmlp
𰾫	oplit
𰾬	opass
𰾭	opbbe
𰾮	optxc
𰾯	opilr
𰾰	opuog
𰾱	ophwp
𰾲	opixp
𰾳	opsjk
𰾴	optzl
𰾵	opjrl
𰾶	opjwp
𰾷	opmua
𰾸	opbux
𰾹	opogs
𰾺	ophws
𰾻	optwk
𰾼	opruc
𰾽	opshb
𰾾	opjbk
𰾿	optav
𰿀	oplic
𰿁	opipp
𰿂	opmzb
𰿃	optwi
𰿄	opwww
𰿅	opuos
𰿆	ophuo
𰿇	ophtn
𰿈	opoim
𰿉	opwwg
𰿊	opynq
𰿋	hismv
𰿌	sicsh
𰿍	lvsmv
𰿎	sika
𰿏	svwg
𰿐	siyiu
𰿐	siyiv
𰿑	singr
𰿒	siheu
𰿓	simxg
𰿔	svile
𰿕	siiih
𰿖	mfpo
𰿗	any
𰿘	anms
𰿙	anno
𰿚	annin
𰿛	ancl
𰿜	anphh
𰿝	anyc
𰿞	annin
𰿟	anklg
𰿠	anmk
𰿡	anobt
𰿢	anjcm
𰿣	anggi
𰿤	anetb
𰿥	lsl
𰿦	mmls
𰿧	lsv
𰿨	lsmmu
𰿩	lsmvh
𰿪	lscsh
𰿫	lsiki
𰿬	lsmfj
𰿭	lsw
𰿮	lshbu
𰿯	lsmrt
𰿰	lshsh
𰿱	lsbb
𰿲	lsapp
𰿳	kdlso
𰿴	lsapv
𰿵	lsobn
𰿵	lsobv
𰿶	lsjch
𰿷	lsmff
𰿸	lshuk
𰿹	lstlc
𰿺	lsfbg
𰿻	lsors
𰿼	lscwa
𰿽	lsdyn
𰿾	lssrl
𰿿	ltjqr
𱀀	lsmwe
𱀁	hjhj
𱀂	hjnd
𱀃	nlmlb
𱀄	nlci
𱀅	hjdk
𱀆	nljr
𱀇	nlhd
𱀈	hjos
𱀉	hrpr
𱀊	nljkn
𱀋	nlgg
𱀌	nlmmx
𱀍	nlkmd
𱀎	nlmyk
𱀏	nlox
𱀐	nlniu
𱀑	nlfhm
𱀒	nlufh
𱀓	hrfb
𱀔	nljio
𱀕	nlife
𱀖	hjice
𱀗	nlta
𱀘	hrgce
𱀙	nlubq
𱀚	nlhdv
𱀛	nlomr
𱀜	hrjog
𱀝	hjhrj
𱀞	nljcm
𱀟	hjyrd
𱀠	rrsbb
𱀡	nljto
𱀢	nlkbl
𱀣	nlamx
𱀤	nlacv
𱀥	nlxle
𱀦	nlhax
𱀧	nlnqg
𱀨	nlfdt
𱀩	nlune
𱀪	nltgb
𱀫	nlifu
𱀬	nldog
𱀭	nlmpm
𱀮	hjbof
𱀯	nljmc
𱀰	nlywv
𱀱	nlqoa
𱀲	nlkuu
𱀳	hrjtc
𱀴	nllkc
𱀵	nlcmi
𱀵	nltwi
𱀶	nltxf
𱀷	nlygq
𱀸	nlmzd
𱀹	nlsjv
𱀺	nlrxr
𱀻	nltoe
𱀼	nlyli
𱀽	nlymi
𱀾	nlofb
𱀿	nlyyr
𱁀	nbop
𱁁	nlsje
𱁂	nooe
𱁃	hrttj
𱁄	hrctr
𱁅	cog
𱁆	ogmi
𱁇	bmog
𱁈	vvog
𱁉	yjog
𱁊	ytrog
𱁋	oghoo
𱁌	ssfog
𱁍	mogv
𱁎	onwog
𱁏	iacog
𱁐	ugssg
𱁑	mzp
𱁒	mzedi
𱁓	mzvih
𱁔	mzgys
𱁕	mzgug
𱁖	mzleg
𱁗	mzwc
𱁘	mzwks
𱁙	mzehk
𱁚	mznls
𱁛	mzdw
𱁜	mzsjn
𱁝	mzsje
𱁞	mzcwj
𱁟	mzyib
𱁠	muau
𱁡	mzhoq
𱁢	mzeog
𱁣	msjbm
𱁤	mwahu
𱁥	mikbb
𱁦	mzbch
𱁧	mzcoy
𱁨	mzjhw
𱁩	mzett
𱁪	mzwwg
𱁫	mzogg
𱁬	mzmp
𱁭	qbjio
𱁮	qbsbe
𱁯	huhuy
𱁰	mworq
𱁱	tjnhh
𱁲	tjbhn
𱁳	tjeq
𱁴	tjppj
𱁵	tjyks
𱁶	tjyhj
𱁷	tjjnk
𱁸	tjtpr
𱁹	tjlmo
𱁺	tjfdv
𱁻	tjtih
𱁼	tjjqr
𱁽	tjlsw
𱁾	tjtlw
𱁿	dqei
𱂀	dqe
𱂁	dqdhe
𱂂	dqhdn
𱂃	qsnhe
𱂄	qsjd
𱂅	qsph
𱂆	qsor
𱂇	fqs
𱂈	qsbkq
𱂉	qsfb
𱂊	qsptd
𱂋	qswli
𱂌	qstoe
𱂍	nolsm
𱂎	yoelm
𱂏	ptya
𱂐	yarbo
𱂑	yabm
𱂒	yawib
𱂓	yaobr
𱂔	hsmz
𱂔	ismz
𱂕	knjmz
𱂖	fmnmz
𱂗	tgmz
𱂘	kdmz
𱂙	avmz
𱂚	mrbmz
𱂛	hbxmz
𱂜	ybsmz
𱂝	ogfmz
𱂞	hurmz
𱂟	hobmz
𱂠	hpmbo
𱂡	onmbo
𱂢	uumbo
𱂣	jumbo
𱂤	unmbo
𱂥	hrmbo
𱂦	ttmbo
𱂧	fdmbo
𱂨	jvmbo
𱂩	ibmbo
𱂪	jkmbo
𱂫	ommbo
𱂬	btmbo
𱂭	ogmbo
𱂮	hjmbo
𱂯	yjmbo
𱂰	uembo
𱂱	ihmbo
𱂲	wpmbo
𱂳	hgmbo
𱂴	tbmbo
𱂵	bbmbo
𱂶	hpmbo
𱂷	ysoyo
𱂸	jcmbo
𱂹	idmbo
𱂺	mfmbo
𱂻	ofmbo
𱂼	pphni
𱂽	yrhni
𱂾	hnnsl
𱂿	puhni
𱃀	hnkhf
𱃁	hnhsh
𱃂	hnnls
𱃃	gehni
𱃄	hnypn
𱃄	hnypu
𱃅	hnbb
𱃆	yrhni
𱃇	pdhni
𱃈	hnjce
𱃉	jehni
𱃊	hnnuw
𱃋	hngsk
𱃌	nnhni
𱃍	hnssf
𱃎	hnoyb
𱃏	nrhni
𱃐	hnipf
𱃑	hnffe
𱃒	hnsjj
𱃓	hnlii
𱃔	hnhhh
𱃕	hnmvh
𱃖	hnvis
𱃗	hnir
𱃘	hnmnn
𱃙	hnykn
𱃚	hnkss
𱃛	hnmso
𱃜	hnhdv
𱃝	hnhnn
𱃞	hnobn
𱃟	sahnk
𱃠	hnikk
𱃡	oimd
𱃡	osmd
𱃢	oimms
𱃢	osmms
𱃣	oimy
𱃣	osmy
𱃤	oavp
𱃥	oimtn
𱃥	oimkn
𱃥	osmkn
𱃥	osmtn
𱃦	oimbl
𱃦	osmbl
𱃧	oifmu
𱃧	osfmu
𱃨	oiryo
𱃨	osryo
𱃩	oilsa
𱃪	oitz
𱃪	ostz
𱃫	oibb
𱃫	osbb
𱃬	oimrr
𱃭	oidyk
𱃭	osdyk
𱃮	tvijk
𱃯	oihbt
𱃯	oshbt
𱃰	oiokt
𱃰	opokt
𱃰	osokt
𱃱	nuon
𱃲	nusk
𱃳	numf
𱃴	nuyy
𱃵	nulbk
𱃶	nuwo
𱃷	nufq
𱃸	numig
𱃹	nuusu
𱃺	nuhjr
𱃻	nuvmi
𱃼	nukjt
𱃽	nuoyo
𱃾	nuytr
𱃿	nuff
𱄀	nujto
𱄁	nuobn
𱄂	nujfe
𱄃	nuneq
𱄄	nurmo
𱄅	nuolh
𱄆	nugrr
𱄇	nunao
𱄈	nutbo
𱄉	nubmp
𱄊	nuhuo
𱄋	tuyj
𱄌	mithu
𱄍	vuirm
𱄎	hammi
𱄏	haiav
𱄐	hayhj
𱄑	isqf
𱄒	sfq
𱄓	sftn
𱄔	sfws
𱄕	sfopd
𱄖	sfnil
𱄗	sfjhu
𱄘	sfrg
𱄙	sflpm
𱄚	sfya
𱄛	sfqd
𱄜	sfeng
𱄝	sfjru
𱄞	sfgug
𱄟	sftru
𱄠	sfhvf
𱄡	sfooi
𱄢	sfife
𱄣	sfpmx
𱄤	sfxo
𱄥	sfhdt
𱄦	sfuke
𱄧	sfyta
𱄨	sfjmm
𱄩	sfqmf
𱄪	sfmwp
𱄫	sfkrb
𱄬	sfhse
𱄭	sfnuw
𱄮	sfxmt
𱄯	sfuaa
𱄰	sfhhp
𱄱	sfnwa
𱄲	sfmxp
𱄳	sfjok
𱄴	bfsqf
𱄵	sfsiq
𱄶	sfnbu
𱄷	sfatp
𱄸	sfhhp
𱄹	sfgoj
𱄺	sfoow
𱄻	sfukz
𱄼	smt
𱄽	smhp
𱄾	smih
𱄿	smsm
𱅀	pjsm
𱅁	sml
𱅂	smnhe
𱅃	smss
𱅄	smike
𱅅	ikpm
𱅆	smkr
𱅇	smohh
𱅈	smph
𱅉	smij
𱅊	qism
𱅊	qksm
𱅋	smsj
𱅌	smlpm
𱅍	smihi
𱅎	smoik
𱅏	smluo
𱅐	smyck
𱅑	fsm
𱅒	smsmm
𱅓	smjbd
𱅔	smdl
𱅕	smdt
𱅖	smrb
𱅗	smhqi
𱅘	smlsd
𱅙	smcru
𱅚	smomr
𱅛	smcwj
𱅜	smmwv
𱅝	ibsm
𱅞	smrse
𱅟	smnzd
𱅠	jjosm
𱅡	smhwi
𱅢	smhdp
𱅣	smbx
𱅤	smjoc
𱅥	smbmo
𱅦	smtlc
𱅦	smtmc
𱅧	smypl
𱅨	smnhs
𱅩	smssa
𱅪	smmwj
𱅫	smnzb
𱅬	smtlf
𱅭	bbmbl
𱅮	bbjpu
𱅯	bbkq
𱅰	bbklu
𱅰	bbklv
𱅱	bbtz
𱅲	bbxb
𱅳	bbmwp
𱅴	yrbn
𱅵	yrbn
𱅶	yrbo
𱅷	ybym
𱅸	mxyb
𱅹	yblwl
𱅺	ybse
𱅻	ybmam
𱅼	ybkg
𱅽	tkyrb
𱅾	yjmam
𱅿	shksr
𱆀	shlsa
𱆁	shlsb
𱆂	shahm
𱆃	shlmo
𱆄	shllo
𱆅	shlit
𱆆	shtmb
𱆇	shkoe
𱆈	shhuo
𱆉	lnjac
𱆊	puip
𱆋	mnrb
𱆌	mbonh
𱆍	mbns
𱆎	xmrb
𱆏	mbnwf
𱆐	ngiz
𱆑	nmkz
𱆒	nirz
𱆓	tgfb
𱆔	nhoz
𱆕	nthz
𱆖	hnhwi
𱆗	hiht
𱆘	phhi
𱆙	hijpu
𱆚	himbo
𱆛	qihwi
𱆜	btyi
𱆝	hshwi
𱆝	ishwi
𱆞	hihqj
𱆟	hiytr
𱆠	himfi
𱆡	jchwi
𱆢	mghwi
𱆣	cnwf
𱆤	nfms
𱆥	nfby
𱆦	aunwf
𱆧	nfng
𱆨	nfihn
𱆩	nfrms
𱆪	nunwf
𱆫	einwf
𱆬	nfppj
𱆭	nfit
𱆮	nftmj
𱆯	nfhdh
𱆰	nfnwu
𱆱	nffmj
𱆲	nfsf
𱆳	nfdci
𱆴	nfdd
𱆵	nfqht
𱆶	nfacv
𱆷	nfose
𱆸	nfyvs
𱆹	nffdv
𱆺	nftgf
𱆻	nfjcu
𱆼	nfnef
𱆽	nfbci
𱆾	nfwld
𱆿	nfmbi
𱇀	nfkoe
𱇁	nfamg
𱇂	nfycv
𱇃	nfmwm
𱇄	nfwww
𱇅	nfwfg
𱇆	nfhet
𱇇	nficq
𱇈	nfybp
𱇉	nfmzr
𱇊	nfmsi
𱇋	nfvfn
𱇌	nftsd
𱇍	nmu
𱇎	nmy
𱇏	nmhp
𱇐	nmmmu
𱇑	nmjb
𱇒	nmpp
𱇓	nmmrm
𱇔	nmob
𱇕	nwmok
𱇖	nmhe
𱇗	nmop
𱇘	nmyhn
𱇙	nmlbu
𱇚	nmdj
𱇛	nmjd
𱇜	nmgi
𱇝	nmmfm
𱇞	nmam
𱇟	nmwl
𱇠	nmwo
𱇡	nmhqm
𱇢	nmyvi
𱇣	nmive
𱇤	nmvis
𱇥	nmmam
𱇦	nmkms
𱇧	nmkn
𱇨	nmymf
𱇩	nmhkl
𱇪	nmher
𱇫	vrnwm
𱇬	nmsll
𱇭	nmdt
𱇮	nmtyv
𱇯	nmfb
𱇰	nmrau
𱇱	olhm
𱇲	nmbnd
𱇳	nmice
𱇴	nmvmb
𱇵	nmqmo
𱇶	nmgcg
𱇷	nmta
𱇸	nmrlu
𱇹	hnnwm
𱇺	nmhdd
𱇻	nmnx
𱇼	nmhyr
𱇽	nmpfd
𱇾	nmjmf
𱇿	nmlf
𱈀	nmsjr
𱈁	nmnex
𱈂	nmwib
𱈃	nmwb
𱈄	nmosk
𱈅	nmuce
𱈆	nmfdv
𱈇	nmpmm
𱈈	nmpmm
𱈉	nmypk
𱈊	nmhhw
𱈋	nmyrb
𱈌	nmtqg
𱈍	nmnmm
𱈎	nmeed
𱈏	nmymo
𱈐	nmjwi
𱈑	hknwm
𱈒	nmtzl
𱈓	nmmwj
𱈔	nmmua
𱈕	nmhfw
𱈖	nmdlo
𱈗	nmmzb
𱈘	nmfba
𱈙	nmtwi
𱈚	nmmrr
𱈛	nmtbu
𱈜	nmnmm
𱈝	hzms
𱈞	hmlhz
𱈟	sohz
𱈠	rvhz
𱈡	ymyhz
𱈢	uxhz
𱈣	hzam
𱈤	eehz
𱈥	irhz
𱈦	twhz
𱈧	yhphz
𱈨	hzihs
𱈩	qndhz
𱈪	hzav
𱈫	hzamj
𱈬	ytdhz
𱈭	qmvhz
𱈮	ddhz
𱈯	abhz
𱈰	hzhor
𱈰	hzhyr
𱈱	yrjhz
𱈲	fdvhz
𱈳	jckhz
𱈴	dvhz
𱈵	mwphz
𱈶	wzph
𱈷	xlehz
𱈸	hmthz
𱈹	ssfhz
𱈺	koehz
𱈻	qoahz
𱈼	gblhz
𱈽	rruhz
𱈾	dahz
𱈿	jehz
𱉀	twphz
𱉁	hzxif
𱉂	jmnhz
𱉃	uwfhz
𱉄	hclhz
𱉅	tghz
𱉆	hzaue
𱉇	hmn
𱉈	shhym
𱉉	nnhym
𱉊	mjhym
𱉋	hmmj
𱉌	hmik
𱉍	mghym
𱉎	qohym
𱉏	qihym
𱉐	bohym
𱉑	chhym
𱉒	bhym
𱉓	ishym
𱉔	dkhym
𱉕	hmmnr
𱉖	mmhym
𱉗	amhym
𱉘	bmhym
𱉙	hmrc
𱉚	hohym
𱉛	okhym
𱉜	odhm
𱉝	aihym
𱉞	wyhym
𱉟	eqhym
𱉠	nmhym
𱉡	ithym
𱉢	viksm
𱉣	hmij
𱉣	hmik
𱉤	gghym
𱉥	grhym
𱉦	qphym
𱉧	jihym
𱉨	mlhym
𱉩	knhym
𱉪	tkhym
𱉫	hdhym
𱉬	hlhym
𱉭	nuhym
𱉮	hrhym
𱉯	tqhym
𱉰	fchym
𱉱	bqhym
𱉲	iqhym
𱉳	nkhym
𱉴	dhhym
𱉵	dthym
𱉶	ajhym
𱉷	hohem
𱉸	hmomd
𱉹	kbhym
𱉺	bdhym
𱉻	bvhym
𱉼	aislm
𱉽	sphym
𱉾	iehym
𱉿	hmice
𱊀	gghym
𱊁	krhym
𱊂	abhm
𱊃	hhhym
𱊄	hmxhu
𱊅	hymog
𱊆	nihym
𱊇	pdhym
𱊈	xuhym
𱊉	fdhym
𱊊	jmhym
𱊋	ibhym
𱊌	srhym
𱊍	eeeem
𱊎	vwhym
𱊏	mwhym
𱊐	pahym
𱊑	huhym
𱊒	behym
𱊓	behym
𱊔	oehym
𱊕	ybhym
𱊖	jkhym
𱊗	ndhym
𱊘	rohym
𱊙	qvhym
𱊚	jchym
𱊛	ojhym
𱊜	hmhmm
𱊝	irhym
𱊞	edlm
𱊟	jrhym
𱊠	tfhym
𱊡	rghym
𱊢	hthym
𱊣	owhym
𱊤	ibhym
𱊥	yrhym
𱊦	gthym
𱊧	mtom
𱊨	hmesd
𱊩	sahym
𱊪	mnhym
𱊫	ykhym
𱊬	wihym
𱊭	xchym
𱊮	ykhym
𱊮	ynhym
𱊯	hkhym
𱊰	yphym
𱊱	sghym
𱊲	aehym
𱊳	wwhym
𱊴	tlpm
𱊵	obhym
𱊶	ywoj
𱊷	ywjmn
𱊸	ywcon
𱊹	ywnla
𱊺	ywg
𱊻	ywmt
𱊼	ywase
𱊽	ywywv
𱊾	ipbme
𱊿	ipife
𱋀	ipydf
𱋁	ipixp
𱋂	ipnmb
𱋃	deta
𱋃	keta
𱋄	qems
𱋅	qep
𱋆	qeu
𱋇	qeon
𱋈	qei
𱋉	qeq
𱋊	qedj
𱋋	qegi
𱋌	qehd
𱋍	qeyg
𱋎	qejc
𱋏	qecr
𱋐	qetw
𱋑	qehkl
𱋒	qehbu
𱋓	qeher
𱋔	qett
𱋕	qefd
𱋖	qeijb
𱋗	qebnd
𱋘	qeefh
𱋙	qewd
𱋚	qehew
𱋛	qehdd
𱋜	qmeog
𱋜	qkeog
𱋝	qeytr
𱋞	gehne
𱋟	qejrb
𱋠	qeobn
𱋠	qnobv
𱋡	qefdv
𱋢	qecmw
𱋢	qetcw
𱋣	qenzd
𱋤	qenhk
𱋥	nkqme
𱋦	qeohw
𱋧	qetgm
𱋧	qetqm
𱋧	qntgm
𱋧	qntqm
𱋨	qeteh
𱋩	qehjo
𱋪	qeyjr
𱋫	qetlc
𱋫	qetmc
𱋬	qefdq
𱋭	qedtt
𱋮	qetbo
𱋯	ichgr
𱋯	idhqr
𱋰	icdoo
𱋰	iddoo
𱋱	icjto
𱋱	idjto
𱋲	tchqm
𱋳	tcyiu
𱋴	tccwj
𱋵	hephf
𱋶	wfys
𱋷	wfivi
𱋸	wfhej
𱋹	wfnwa
𱋺	wfhgi
𱋻	ginxu
𱋼	pwba
𱋽	napw
𱋾	gcrlu
𱋾	gcrwu
𱋿	giru
𱌀	lkrlu
𱌀	lkrwu
𱌁	prrwu
𱌁	prrlu
𱌂	ruhem
𱌂	ruhey
𱌃	ggrwu
𱌃	ggrlu
𱌄	orrlu
𱌄	orrwu
𱌅	xcrlu
𱌅	xcrwu
𱌆	bcrlu
𱌆	bcrwu
𱌇	fkrwu
𱌇	fkrlu
𱌈	icrlu
𱌈	icrwu
𱌈	idrwu
𱌈	idrlu
𱌉	slrlu
𱌉	slrwu
𱌊	gepo
𱌋	gemnr
𱌌	geltn
𱌍	xvni
𱌎	xvyvo
𱌏	xvbkq
𱌐	xvcxf
𱌐	xvtxf
𱌑	hty
𱌒	hlo
𱌓	hthml
𱌔	hthqm
𱌕	htkt
𱌖	hthbv
𱌗	ykllf
𱌘	yklt
𱌙	ykllv
𱌚	xuik
𱌛	xuook
𱌜	xucsh
𱌝	xuopd
𱌞	xuife
𱌟	qixuo
𱌠	dsxuo
𱌡	xuytr
𱌢	xujfb
𱌣	xujsv
𱌤	xuyhj
𱌥	dkxuo
𱌦	bvxuo
𱌧	xumwm
𱌨	xusjf
𱌩	xum
𱌪	xuyk
𱌫	xurc
𱌬	xuos
𱌭	xuns
𱌮	xupr
𱌯	xuir
𱌰	xujpu
𱌱	xulwp
𱌲	fxuo
𱌳	xubkq
𱌴	xudt
𱌵	xuofm
𱌶	xusje
𱌷	xumgg
𱌸	hnxuo
𱌹	xuwib
𱌺	xujbc
𱌻	xugit
𱌼	xutqm
𱌽	xutct
𱌾	ypmob
𱌿	mtybp
𱍀	grybp
𱍁	ikpt
𱍂	ipikp
𱍃	knwu
𱍄	bmnwu
𱍅	nupi
𱍆	nwuf
𱍇	hmnwu
𱍇	hynwu
𱍈	fknwu
𱍉	obnwu
𱍊	obaa
