𭥗	aa
𭬀	aadd
𭨖	aafc
𭧌	aafu
𭦠	aaht
𭥳	aaj
𭧴	aand
𭨋	aatj
𭨃	aatp
𭦂	aav
𭧸	aavo
𭎮	abg
𭧏	abhx
𭦈	abmc
𭨄	abmp
𭦊	abnd
𭥤	abr
𭞕	absp
𭦗	abts
𭧎	abvk
𭧯	abyhv
𭨆	acav
𭥨	ache
𭧗	acjdi
𭨏	actmc
𭬀	adad
𭧔	adoe
𭥚	ae
𭥺	aem
𭴋	af
𭧨	afbk
𭧋	afbu
𭥻	afd
𭨇	afdb
𭧲	afff
𭥽	afmc
𭧟	afno
𭦣	afqu
𭨗	afwrw
𭦩	agcu
𭨍	aggc
𮭇	aghaf
𭨎	agirm
𮡛	agqhp
𭨉	agrg
𭧘	ahaf
𭦸	ahak
𮙸	ahbuc
𭦏	ahdn
𭥵	aher
𭧐	aheu
𭦢	ahhl
𭥥	ahhn
𭥹	ahjr
𭃶	ahln
𭦡	ahlo
𭨷	ahlr
𭧜	ahnd
𭧞	ahnh
𭭐	ahno
𭧮	ahos
𭦶	ahov
𭝓	ahp
𭧚	ahpdk
𭦵	ahrg
𭨌	ahsf
𭧺	ahsfd
𭦺	ahxo
𭦕	aice
𭥠	aihu
𭥢	aije
𭧠	aile
𭥊	aimuj
𭨴	ain
𭦥	aioi
𭔳	aipd
𭥿	aiq
𭧶	ajaf
𭧃	ajbbe
𭦬	ajbc
𭦑	ajce
𭦿	ajce
𭦒	ajcn
𭦞	ajhgu
𭧄	ajiav
𭧧	ajii
𭦤	ajmo
𭦝	ajoii
𭦜	ajomj
𭦝	ajoml
𭥡	ajon
𭅸	ajsl
𭧥	ajtc
𭧵	ajwv
𭧓	ajyrn
𭧓	ajyru
𭥏	ak
𭥯	akb
𭥱	akdi
𭦭	akgg
𭧤	akja
𭦛	akmf
𭞘	akp
𭦀	akss
𮭅	alhaf
𭧖	allv
𭧫	almc
𬻴	aloii
𬻴	aloml
𭥐	am
𭥒	ame
𭨁	amfb
𭥕	amg
𭧇	amgk
𭦄	amgt
𮭇	amhaf
𭥔	amk
𭧼	amlsb
𭥓	ammi
𭥖	ammu
𭥌	amn
𮟻	amnl
𭦷	amob
𭧻	amtbs
𭧅	amwd
𭧰	amwg
𭨅	amybb
𭥋	an
𮤔	anaio
𮤊	anbbm
𮤊	anbt
𮤧	ancoi
𮤧	ancol
𭧬	ancr
𭥛	andu
𮤥	aneba
𮤏	anem
𮤎	anfmu
𮤝	angge
𮤢	anggv
𮤦	anhbk
𭦁	anhn
𮤠	anhnd
𮤤	anhuj
𮤌	anhvo
𭥑	ani
𮤞	anifs
𭥸	anii
𭥧	anij
𭥦	anil
𮤍	anir
𭦋	ankm
𭦋	ankv
𮤋	anlbk
𭦧	anme
𮤞	anmfs
𮤜	anmje
𮤩	anmpc
𮤟	anmtl
𮤈	anmvu
𮤗	anmwg
𮤪	anmwg
𮤜	annje
𮤛	annkw
𮤉	anno
𮤣	anogd
𭦁	anpu
𮤐	anqje
𮤑	anqje
𮤒	anqmb
𮤡	ansma
𭦻	anst
𮤕	antau
𮤙	antjr
𮤘	antmv
𭦴	anus
𮤚	anvik
𭧛	anwu
𮤨	anykj
𮤖	anysk
𭥷	aoa
𭦍	aobu
𭥶	aod
𭧭	aogf
𭧦	aohqi
𭦯	aohvp
𭨑	aomb
𭨣	aomb
𮧏	aomwr
𬼲	aoon
𭦎	aoos
𭕦	aoso
𭥲	apa
𭦼	apav
𭦬	apbc
𭨝	aphl
𭯐	aphl
𭦅	appg
𭥭	apvy
𭥮	aqhp
𭧈	aqif
𭦐	aqjl
𭦮	aqjm
𭫁	ard
𭏏	arg
𭤤	arhml
𭦱	arsj
𭧍	arwg
𭕁	asei
𭞮	asep
𭧿	asit
𭦦	asjb
𭥞	ask
𭥰	asmg
𭧿	asmt
𭧾	asuf
𭦔	asuk
𭨕	aswu
𭨊	ataa
𭧕	atbu
𭧱	atca
𭧂	atcp
𭦲	atkr
𭧉	atmb
𭥪	atmm
𭭑	atno
𭧩	atyj
𭦇	atyv
𭴫	auf
𭧊	aunk
𭡣	auq
𭘏	auqyt
𭇋	aur
𭿰	autwd
𭧊	auuk
𭨢	auup
𮚯	auybc
𭾁	avbt
𭶐	avf
𭧑	avgi
𮍻	avhjr
𭦹	avhmy
𭦧	avne
𮭨	avpym
𭻓	avw
𭧪	awgf
𭦉	awks
𭨒	awlg
𭦟	awls
𭦽	aybb
𭨓	aybk
𭨈	aybu
𭧽	aycv
𭥙	ayhn
𭧙	ayhr
𭥾	ayhv
𭦓	ayiu
𭧒	ayjj
𭦆	ayk
𭥼	aylc
𭧷	ayps
𭦾	ayrn
𭞳	ayrp
𭦾	ayru
𭥩	ayt
𭨽	bab
𮮡	bae
𭁼	bamo
𭨲	bann
𮌝	baph
𭞀	bavp
𭩊	bbbe
𭩖	bbcv
𮪭	bbhdv
𭯁	bbhne
𮪨	bbhqm
𮪦	bbj
𭩇	bbjcm
𮪴	bbjii
𮊜	bbjks
𮪵	bbjtg
𮪪	bbkoo
𮪧	bblbk
𭶪	bbmm
𭩑	bbmp
𮥾	bbog
𮪮	bbomb
𭐫	bbpe
𮪳	bbstr
𮪰	bbtkr
𭁷	bbuc
𭶰	bbuv
𮪱	bbvvw
𮪲	bbyav
𭉥	bbyhn
𮪩	bbyhv
𮪫	bbyma
𮪬	bbynp
𮪯	bbyok
𮚐	bcab
𮙻	bcam
𮚮	bcbok
𮚗	bcbup
𮙮	bcdi
𮚢	bcgbt
𭁹	bcgg
𮚤	bchdw
𭐯	bche
𮙽	bches
𮚝	bchni
𮙯	bcho
𮊏	bchoo
𮚇	bchvf
𮚆	bcit
𮚪	bcjmc
𮚉	bcjmu
𮚫	bcjpn
𭒱	bcjv
𮚎	bckmf
𮙰	bclll
𮚞	bcmpc
𭨯	bcms
𮉾	bcmvj
𮙵	bcmvu
𮙴	bcmys
𭛋	bcn
𮌏	bcn
𮚓	bcnme
𮙼	bcodi
𮙾	bcof
𮚒	bcofd
𮚭	bcogk
𮙽	bcoks
𮚈	bcoos
𮙳	bcqo
𭉦	bcrp
𮚀	bcrvp
𮙱	bcsm
𮚟	bcstr
𮚩	bctbo
𮚛	bctvg
𭖊	bcu
𮚄	bcvif
𭂄	bcvio
𮚓	bcvne
𮊗	bcvvd
𮚖	bcwa
𭂂	bcwlt
𭾕	bdbt
𭂃	bddf
𭣲	bdok
𭯏	bdpp
𮌥	bdwf
𭫫	bdwks
𭓜	bdytg
𮌹	becd
𭐂	beg
𮌋	beii
𭨬	bf
𭁨	bfd
𭤣	bfhml
𭩃	bfqe
𭩅	bfqf
𮂤	bfqly
𭁱	bgfg
𮭠	bghaf
𭎈	bgnd
𮌺	bgrr
𭶬	bgy
𭤒	bgye
𮙧	bhbhn
𮙪	bhhap
𮙦	bhi
𮙩	bhjhu
𭁦	bhjr
𭉅	bhlk
𭃤	bhln
𮙨	bhodi
𮌸	bhsb
𭶮	bhso
𮙫	bhybb
𮙬	bhytg
𭁿	bife
𭁺	bifi
𮌤	bikp
𮌣	bilb
𭨵	bim
𭨺	bimr
𮍄	bims
𮌸	bisb
𮙡	bjmso
𭩋	bjmx
𮝁	bjwj
𮍁	bjwv
𮊎	bkakb
𮊓	bkibp
𮌞	bkkb
𮊌	bkkv
𮊔	bkpog
𮊖	bkref
𮊄	bkrvp
𮌯	bksb
𮊘	bksfi
𭂁	blaf
𭨶	bleg
𭨮	blk
𮌡	blpb
𭁽	blsf
𭩏	bmak
𭁴	bmam
𭁶	bmau
𮌻	bmbi
𭩗	bmbo
𭩒	bmbv
𭁿	bmfe
𭁺	bmfi
𭶭	bmgb
𮍃	bmgn
𭑑	bmik
𭩆	bmmc
𬻞	bmmm
𮟰	bmnl
𭨹	bmpm
𮌸	bmsb
𭨩	bmt
𮍇	bmtp
𭁵	bmuk
𮌦	bmvb
𭶷	bmyiu
𭩈	bnbo
𭴮	bndf
𭩉	bneu
𮍀	bnjc
𭨱	bnln
𭨥	bnn
𭨧	bnn
𭭆	bnno
𭁒	bno
𮌰	bnof
𮌪	bnqd
𬼄	bns
𭩄	bnwp
𮌷	bobh
𮊇	boea
𮊁	bojr
𭨦	bol
𮌧	bolk
𭨫	boll
𭾽	bolmu
𭨸	bomr
𭨻	bomr
𭁾	bose
𭩐	botq
𮈏	bovif
𭧀	bowla
𮊊	boybb
𮘳	boymr
𮊞	boyx
𮌒	bpd
𮌢	bpnp
𮌚	bpom
𮌚	bpov
𮌍	bpvo
𭁠	bq
𭛓	bqhhh
𮌓	bqho
𭂅	bqjp
𭩁	bqlr
𮟯	bqnl
𮟳	bqnl
𮭆	brhaf
𭟳	bri
𮨒	brmbc
𭁰	brnin
𮟱	brnl
𮠊	brnl
𭊐	bromr
𭁳	bru
𭞌	brwp
𮌘	bryo
𬼁	bs
𮌲	bseg
𮙥	bsho
𭨭	bsk
𭨤	bsl
𭩎	bsme
𭁻	bsw
𮌼	btak
𮍆	btbi
𮌌	btc
𮌮	btge
𭨰	btk
𮟰	btnl
𮌵	btod
𭩍	btub
𭾻	buad
𭿦	buaja
𭿝	buamg
𮌴	buap
𮗑	buav
𭶴	bubm
𭾘	buc
𭿒	bucj
𭿴	budii
𭿤	budoe
𭿁	bueee
𭵀	buf
𭿎	bufdk
𭿢	bugte
𭿟	buhaj
𭾵	buhgr
𭩂	buhi
𭿍	buhjg
𭿚	buhkr
𭂷	buhn
𭿉	buhov
𭾵	buhqr
𭿛	buhsb
𭾾	buhsl
𭿙	buhuh
𭾦	buii
𭿚	buikr
𭿂	buili
𭾣	buino
𭾿	buiqo
𭿛	buisb
𭾗	buj
𭿬	bujac
𭿜	bujbc
𭾶	bujcn
𭾷	bujio
𭿤	bujoe
𭿥	bujtq
𭾚	buk
𭿗	bukt
𮗙	bulnh
𭿮	bulpc
𭾫	bulwp
𭾟	bumf
𭿚	bumkr
𭿖	bummf
𭾨	bumnr
𭿛	bumsb
𭾾	bumsl
𭾡	bumvv
𭾝	bund
𭾸	bunib
𭾯	bunmu
𭾙	bunn
𭾢	buok
𭾼	buomr
𭾮	buoq
𭿪	buoye
𮌗	bupp
𭿈	bupyr
𭿅	buqkk
𭾳	buqky
𭾺	buqyt
𭿱	burpf
𭿞	burrj
𮗕	busje
𭾥	busk
𭾲	busmm
𭾤	bussm
𭿣	butbm
𭿔	butgf
𭿫	butgt
𭾧	butm
𭿘	butmm
𭿄	butmv
𭾞	butt
𭾠	butt
𭿆	butvu
𭿕	butwa
𭿇	buuli
𮮥	buvlh
𭿑	buwjt
𭿳	buwlg
𭿏	buyrn
𭿭	buyro
𭿏	buyru
𭿨	buyto
𭾰	buyvv
𭿯	buywv
𭾒	bvbt
𭶯	bvii
𮨑	bvmbc
𭺩	bvmvn
𭢩	bvq
𭆲	bwle
𭩓	bwlp
𭂀	bwlv
𬻱	bwuom
𮨚	bxmbc
𭁸	byaj
𮍊	bydu
𮌨	byhq
𭨳	byhv
𭨪	bylm
𮌖	byma
𮌶	bypn
𮌠	bysy
𮌟	bytv
𭨟	cadh
𮙞	caho
𮢆	caht
𮡲	caj
𮣰	cbce
𮢻	cbof
𮯜	cbssw
𮡱	cbt
𮢪	cbun
𮢼	ccct
𮢅	cdd
𮣠	cdoc
𮢧	cebc
𮢤	cehr
𮡾	cene
𮢚	cfbd
𮣖	cfqr
𮢵	cgco
𮣑	cgri
𮢡	chaa
𭪗	chd
𮢢	cheq
𭛊	chjmo
𮣜	chob
𭚾	choii
𮣚	chok
𭚾	choml
𮡳	chpl
𮌬	chrb
𮢌	chrj
𮢏	chrn
𮣀	chsb
𮊺	chsmm
𮣬	chtl
𮣕	chua
𭄃	chune
𭁎	cibm
𭁓	ciijb
𮡧	cik
𭁍	ciklb
𮢲	cikw
𮢘	cilo
𮟭	cinl
𮡿	cino
𮣏	ciod
𮣤	ciof
𮢯	ciop
𮣱	cipp
𮣀	cisb
𮢑	ciss
𭁜	civdl
𮣘	cixf
𭁅	ciy
𮢔	ciyg
𮢰	cjce
𮢰	cjck
𮣨	cjcv
𮡮	cjd
𮢨	cjig
𮢾	cjim
𮢜	cjir
𮣉	cjjc
𮣠	cjoc
𮢷	cjpr
𮢖	cjqk
𮣫	cjtr
𮢎	ckcn
𮢎	ckdn
𮢺	ckhc
𭷕	ckhq
𭶼	ckjwj
𭄽	ckks
𮡵	ckna
𭶻	ckr
𭄍	cksh
𮡷	ckss
𮮕	ckwgf
𭶺	cky
𮡥	clb
𮡸	cleg
𮬨	clhaf
𮣗	clik
𮣪	clpc
𮣯	clvc
𮢋	clwt
𮡨	cmdm
𮣙	cmdm
𮢙	cmmk
𮣟	cmmm
𮢂	cmoe
𮣤	cmof
𮢯	cmop
𮣞	cmrg
𭟹	cmrlr
𮣀	cmsb
𮢑	cmss
𮢩	cmue
𭁗	cmwk
𬼸	cn
𮡺	cnai
𮣈	cnbe
𮡼	cnfn
𮡯	cnil
𮡻	cnkq
𮢦	cnob
𮣅	cnoc
𮢀	cnoe
𮡺	cnshi
𭶽	cntcg
𮢛	cnws
𮣛	cogb
𮢍	cohr
𮡫	coi
𮣧	coid
𭠔	coin
𮡴	coke
𮡰	comj
𮡽	cook
𭊖	cor
𭆮	core
𮣧	cosd
𮡶	cosk
𮣆	cotb
𮢬	cpmr
𮣇	cqrj
𮙎	crjki
𭑉	crk
𮙌	crlbu
𭃣	crln
𮣥	crmr
𮟲	crnl
𮙍	crnmu
𮣦	crrr
𮢇	crvd
𮡭	cse
𮣌	csfv
𭁋	cshb
𭂭	cshn
𭃓	cshn
𮛍	csho
𮀎	cshr
𮕮	cshv
𮡦	csim
𮢄	csjl
𮣎	csmp
𬼺	csnh
𮢁	csup
𮢽	ctbi
𮢴	ctcr
𮢫	cthb
𮢈	ctkc
𮣔	ctkn
𮢫	ctmb
𮢞	ctmo
𮣢	ctob
𮣝	ctof
𮢮	ctqb
𭽦	cudhe
𮡩	cuj
𭀧	cumj
𭕍	cumj
𭭌	cuno
𮢊	cuoi
𮢊	cuol
𭣭	cuye
𭣳	cuye
𮍈	cvb
𮡪	cvnh
𮣍	cvvc
𮫲	cwfa
𭁏	cwhj
𮡹	cwik
𮫭	cwk
𭄫	cwks
𮣓	cwli
𮢟	cwlm
𮣒	cwmi
𮢠	cwpp
𮢉	cwyg
𮣮	cybg
𮣐	cycv
𮢿	cyia
𮣃	cyji
𮢕	cykl
𮢱	cylq
𮢃	cymr
𮣁	cymu
𮢹	cypn
𮢐	cyq
𮢓	cysk
𮡤	cysm
𮢣	cyta
𮣊	cytc
𮢭	cytt
𮢥	cyue
𮣭	cyvp
𮡬	cyy
𮢭	cyyj
𭬸	dano
𭩷	dap
𮋆	dasm
𭪟	dayk
𭵱	dbef
𭭇	dbno
𭞧	dbp
𭬄	dbta
𭣯	dbye
𭬭	dcae
𭩺	dcbm
𭴑	dcc
𭫴	dchd
𭫼	ddbb
𭵦	ddbf
𭫽	ddd
𭪞	ddf
𭫬	ddf
𭏝	ddg
𭐧	ddhe
𮨴	ddhnk
𭆟	ddi
𭬴	ddihc
𭪝	ddik
𭬴	dditc
𭪘	ddje
𭬑	ddkq
𮠏	ddkru
𭮜	ddmnp
𭃩	ddsh
𭬊	ddsju
𭒓	ddv
𭽮	debau
𭽧	dehgu
𭽱	dehhw
𭫵	dehi
𭽰	dehjg
𭽣	dehvi
𭽣	dehvm
𭽳	deibp
𭽫	deice
𭩻	dejk
𭪂	demn
𭽩	denmu
𭽤	deopd
𭽨	deoq
𭽲	depup
𭽥	detc
𮮁	detwa
𭽭	deyfe
𭫖	dfbc
𭩽	dfd
𭵾	dff
𭬿	dfff
𮨕	dfmbc
𭫰	dfqd
𭫯	dfqf
𭬨	dgde
𭵣	dgf
𭬔	dgim
𬼦	dgn
𭝦	dgp
𭫟	dhay
𭪩	dhbn
𭬂	dhdb
𭪊	dheh
𭫂	dhei
𭬾	dhei
𭩨	dhes
𮫒	dhfbw
𭫗	dhje
𭬣	dhju
𭬬	dhmd
𭿹	dhomr
𭬤	dhqe
𭭁	dhub
𭩾	diau
𭫣	diek
𭩤	dih
𭩴	dihs
𭩚	dik
𭬙	diob
𭬶	diob
𭭀	dipw
𭩰	dive
𮪺	diyrb
𭬕	djjd
𭪮	djnp
𭪷	djtd
𭫏	djtd
𭭃	djuc
𭫥	dkbb
𭫆	dkhi
𭬃	dkiy
𭫠	dkja
𭄺	dkks
𮔳	dklmi
𭪅	dkmr
𭩝	dkp
𭡋	dkq
𭬡	dlbk
𭶚	dlf
𭸋	dlik
𭩛	dlis
𭫀	dlmo
𬼥	dln
𭪈	dlsk
𭪾	dlsm
𭪓	dlsp
𭣴	dlye
𭫓	dmam
𭫻	dmba
𭬓	dmbd
𭬵	dmbn
𭬋	dmbu
𭬒	dmdm
𭫸	dmef
𭬛	dmei
𭬻	dmfc
𭩜	dmg
𭪸	dmgl
𭪇	dmkr
𮔼	dmlmi
𭪚	dmlo
𭫾	dmmd
𭩣	dmms
𭩵	dmna
𭇁	dmr
𮧯	dmrlb
𮧮	dmrmb
𭞈	dmrqp
𭫡	dmrv
𭭂	dmwf
𭬞	dmwj
𭩙	dmy
𭩘	dn
𭪔	dndk
𭫸	dnef
𭬛	dnei
𭫜	dnhb
𭩪	dnil
𭩹	dnir
𭬇	dnlm
𮨊	dnmbc
𭬰	dnmm
𭫷	dnoi
𭝥	dnp
𭪏	dnsr
𮮂	dnthj
𭪣	dobp
𭏷	dog
𭬥	dogb
𭫺	doge
𭬘	dogf
𭬁	dojp
𭪊	dokh
𭩨	doks
𭬉	doku
𭩫	dom
𭩧	domj
𭪉	domm
𭪌	doos
𭩬	dopd
𭫃	dort
𭫚	doyj
𭬐	dpai
𭬦	dpgf
𭬠	dpke
𭩳	dppp
𮧲	dqbla
𮧱	dqhjd
𮌁	dqji
𭫦	dqkf
𭄵	dqks
𭪄	dqme
𮀇	dqok
𮧳	dqotb
𭬖	drhf
𭬪	drji
𭪵	drok
𭫍	drse
𭪁	dshh
𭫞	dslk
𭪜	dslo
𭆉	dsm
𭬆	dsmb
𭬗	dtbm
𮚅	dtbuc
𭫝	dtdt
𭫐	dtgb
𭪲	dtgn
𭬮	dtgs
𮫗	dthe
𭫤	dtjs
𭬼	dtlk
𭪯	dtlw
𭪶	dtme
𭫿	dtmq
𭫩	dtnb
𭪺	dtnh
𬻮	dtnin
𭬈	dtog
𭬝	dtor
𭪡	dtpi
𭬩	dtrj
𭪀	dtt
𭫨	dtvg
𬻢	dtyj
𭪒	dtyo
𭪤	dumj
𭪦	dumr
𭜷	dup
𭩯	dve
𭩡	dvil
𬻩	dvmy
𭩟	dvo
𭬧	dvoi
𭪽	dvru
𮟽	dwnl
𭫧	dwomd
𭫶	dycb
𭬍	dycr
𭪆	dydi
𭪧	dyhl
𭫙	dyhr
𭪱	dyid
𭪐	dymr
𭬜	dymt
𭩦	dymy
𭫳	dypd
𭬳	dyrg
𭫊	dyrv
𭫛	dysm
𭬹	dysm
𭬱	dysq
𭬯	dytf
𭫲	dytv
𭫕	dyuc
𭫉	dyue
𭬎	dyvg
𭫱	dyvv
𭲟	eaaa
𭳃	eajc
𭯸	eal
𭲮	eamk
𭳽	eanq
𭲻	eant
𭲀	eanu
𮭓	eapf
𭱵	ebbe
𭳴	ebch
𭳄	ebdb
𭲡	ebdd
𭰹	ebfd
𭏺	ebg
𭲧	ebhh
𭱯	ebhi
𭱯	ebhm
𭲦	eble
𬼱	ebn
𭞸	ebp
𭰁	ebru
𭲢	ebta
𭰲	ebtt
𭱑	ebub
𭱭	ebui
𭱗	ebyt
𭲯	eclr
𭰩	edbn
𭲸	edbn
𭪳	edd
𭰿	eded
𭳬	edfe
𭎦	edg
𮭊	edhaf
𭄅	edln
𭰉	edm
𭫌	edym
𭾔	eebt
𮢗	eec
𭩞	eed
𭪰	eed
𭵺	eef
𭶉	eef
𮔓	eelmi
𭝙	eep
𭰽	eep
𭰥	eepm
𭱚	efbd
𭱞	efbr
𭳳	effn
𭳳	effu
𭐉	efg
𭲷	efqc
𭲈	efqd
𭲊	efqf
𭱜	efqg
𭱱	efqk
𭲌	efqk
𭰎	efsm
𭱥	egbr
𭳜	egde
𭰦	egi
𭱇	egik
𭰚	egil
𭱅	egns
𭱅	egus
𭲓	egwp
𭲇	ehah
𭲄	ehau
𭲰	ehav
𮣋	ehc
𭃹	ehcsh
𭲱	ehdl
𭳣	ehed
𭰸	ehem
𭰄	ehes
𭯺	ehg
𭯷	ehi
𭲺	ehjd
𭳆	ehkf
𭰡	ehkt
𭳶	ehmb
𭰂	ehml
𭰆	ehnm
𭰵	ehom
𭲆	ehor
𭲤	ehou
𭳥	ehrc
𭱘	ehsc
𭳅	ehuk
𭯹	ehvl
𭳢	ehxc
𭇛	eie
𭰢	eihs
𭰈	eihu
𭰢	eiis
𭳆	eikf
𭃆	eiln
𭆭	eilp
𭳍	eimi
𭰢	eims
𭲘	eipc
𭱲	eipp
𮑯	eipr
𭱠	eird
𭱙	eitb
𭇜	eive
𭳞	ejak
𭲶	ejcg
𭲩	ejco
𭰓	ejhp
𭲽	ejjb
𭱆	ejjn
𭱤	ejjn
𭱸	ejjn
𭲨	ejju
𭰉	ejll
𭲚	ejmp
𭱹	ejpr
𭱦	ejrt
𭱢	ejss
𭳪	ejtd
𭳉	ejtk
𭳈	ejtu
𭲚	ejvp
𭲖	ejwp
𭲼	ekbm
𮢗	ekc
𭲜	ekcc
𭰒	ekd
𭰶	ekhg
𭆩	eklg
𭰶	ekmg
𭰏	eknd
𭳑	ekod
𭲛	ekou
𭳟	ekuf
𭱬	elce
𭏰	elg
𭱎	ellb
𭱪	ellb
𭱽	ellb
𭱳	elok
𭟌	elp
𭰝	elsl
𭳂	elwv
𭲬	embc
𭱈	embi
𭳺	embp
𭯺	emg
𭲙	emgf
𭳆	emkf
𭰀	emks
𬻶	eml
𭲒	emma
𭱋	emmb
𮨝	emmbc
𭱊	emmo
𭰌	emnn
𭱍	emrj
𭰛	emrs
𭱍	emrt
𭳼	emtg
𭱣	emue
𭯽	emvn
𭳱	emwe
𭳒	emwm
𭲔	emww
𭱘	enbc
𭰾	enkt
𭫎	enkw
𭳋	enlf
𭲪	enli
𭰤	enls
𭲏	enlu
𭰟	eodm
𭰧	eokb
𭰅	eoki
𭰄	eoks
𭃲	eoln
𭲣	eols
𭰷	eoml
𭲥	eomw
𭰑	eonk
𭳮	eooe
𭳤	eooi
𭲠	eook
𭳤	eook
𭰐	eoon
𭳤	eooo
𭰃	eopd
𭱔	eori
𭲃	eort
𭖜	eou
𭰠	eoyg
𭲅	eoyk
𭳕	epec
𭰴	ephb
𭰞	ephr
𭱓	ephu
𭳔	epke
𭱖	epnp
𭯻	epp
𭲹	eppg
𭲕	eqbk
𭳐	eqhw
𭰗	eqme
𭯾	eqmn
𭣧	eqok
𭰬	eqsp
𭰪	eqyt
𭵆	erf
𭏄	erg
𭲭	ermu
𭝴	erp
𮭃	eruf
𭒞	erv
𭲫	eshb
𭱟	esii
𭰮	esje
𭳝	esjf
𭱌	esjj
𭱟	eskk
𭰍	esll
𭰖	esm
𭱟	esoo
𭱃	esqt
𭰨	essu
𭱶	estr
𭰙	eswl
𭳙	esyr
𭲝	etal
𭳲	etap
𭰯	etbi
𭳰	etbi
𭳏	etbp
𭱩	etcb
𭲞	etcb
𭳖	etce
𭱄	etct
𭳭	etei
𭳦	etgf
𭳻	etgf
𭳫	etgq
𭳵	ethf
𭱂	ethq
𭳎	etir
𭳚	etji
𭱺	etjj
𭳊	etkg
𭲉	etkr
𭰼	etks
𭳓	etlb
𭲑	etlc
𭳨	etle
𭲁	etmo
𭰳	etmu
𭱻	etod
𭟕	etp
𭰜	etsu
𭱧	ettn
𭲵	etvf
𭳷	etvm
𭲿	etwn
𭳡	etwn
𭳀	etyw
𭏈	eug
𮋠	eumbl
𭱾	eunk
𭰰	euoi
𭰰	euol
𭒐	euv
𭱒	euvi
𭔻	evdi
𭳌	evfa
𭱴	evfu
𭲎	evmi
𭰕	evnd
𭳛	evnx
𭱀	ewjo
𭑞	ewk
𭳗	ewlf
𭳠	ewlf
𮨡	ewmbc
𭱏	ewmk
𭲂	ewob
𭱿	ewqb
𭊼	ewrhp
𭰊	ews
𭳸	ewwk
𭲋	eybk
𭱝	eyce
𭰺	eycj
𭲗	eygg
𭳩	eyhp
𭇚	eyk
𭲍	eykf
𭲴	eykm
𭆨	eylm
𭆦	eym
𭲾	eyma
𭰱	eymp
𭱕	eyos
𭱨	eypd
𭱼	eypu
𭳁	eypu
𭊅	eyql
𭳇	eyrb
𭱰	eyrd
𭱐	eytn
𭰔	eyuk
𭱛	eyus
𭳹	eyvi
𭰻	eyvt
𭳘	eyvv
𭳧	eywm
𭱫	eywr
𭲳	eywt
𭳯	eyxf
𭴌	fa
𭵹	fabs
𭴽	faf
𮭎	fahaf
𭵑	fami
𭶔	famk
𭵒	fatc
𭵁	fbau
𭵎	fbcn
𭁭	fbe
𭵂	fbhg
𭯝	fbhqu
𭵃	fbik
𮨏	fbmbc
𭵂	fbmg
𭸼	fbmgi
𭕆	fbo
𭝒	fbp
𬻬	fbram
𭓋	fbrnd
𭺮	fbrvm
𭟚	fbrwp
𮚑	fbsbc
𭉢	fbsmr
𭦃	fca
𮭉	fcbhf
𮘐	fcymr
𮇇	fda
𮇘	fdaj
𮇻	fdanb
𮇜	fdav
𮇧	fdbb
𮇨	fdbbe
𮇳	fdbbe
𮇷	fdbhx
𭩼	fdd
𮇥	fddd
𮇹	fdecd
𮇺	fdfqa
𮇕	fdgr
𮇸	fdhaj
𭴗	fdhe
𮇶	fdhhw
𮇚	fdhie
𮇭	fdhje
𮇼	fdhoe
𮇫	fdhss
𮇋	fdii
𮇆	fdiku
𮇫	fdiss
𭣜	fdje
𭓚	fdjrr
𮇃	fdkn
𮇒	fdksr
𮇌	fdlbk
𮇅	fdmmm
𮇫	fdmss
𮇔	fdmtc
𮇢	fdnbg
𭓓	fdng
𮇣	fdnii
𮇙	fdnmu
𮇲	fdnop
𮇮	fdnsp
𮇏	fdohh
𮇯	fdoiv
𮇈	fdokn
𮇡	fdomc
𮇴	fdota
𭟡	fdp
𮇖	fdpa
𭫮	fdptd
𮇠	fdrd
𮇎	fdrp
𮇿	fdrrp
𮇍	fdrsl
𮇟	fdryo
𮇄	fdsl
𮇤	fdsmf
𮇝	fdsmm
𮇗	fdtk
𮇰	fdtor
𮇛	fdtt
𮇩	fduke
𮇑	fduu
𮇱	fdybb
𮇐	fdyg
𮇉	fdyhs
𮇪	fdyrf
𮇞	fdytj
𭴲	fefh
𭴱	fehe
𭞲	fep
𭵞	ffbm
𭭱	ffbmm
𮗵	ffbnb
𮗝	ffbuu
𭶙	ffbw
𮭛	ffdhe
𭛕	fffb
𭶋	ffjph
𮨟	ffmbc
𭵏	ffrg
𮘽	ffye
𮘠	ffymr
𮓭	ffypb
𮭕	fghaf
𭴦	fgil
𭜧	fgp
𭵶	fgsk
𮙷	fhbuc
𭶣	fhcn
𭴅	fhe
𭶔	fhgk
𭵪	fhhi
𮫝	fhhui
𭎇	fhig
𭣝	fhje
𭴡	fhjj
𭶇	fhkd
𭵔	fhke
𭶔	fhmk
𭴄	fhni
𭵗	fhon
𭴓	fhqo
𭴎	fhqu
𭵅	fhsb
𭵚	fhsb
𭵩	fhuk
𭻂	fhw
𭵕	fhxe
𭴰	fif
𮭜	fihaf
𭶇	fikd
𭵬	fing
𭶒	fiod
𭵟	firp
𭵅	fisb
𭵚	fisb
𭵵	fist
𭵽	fjaf
𭵿	fjjb
𭴟	fjmd
𭶁	fjmp
𭴨	fjru
𬺸	fjs
𭶁	fjvp
𮝃	fjwj
𭵊	fkbl
𭬅	fkd
𭰣	fke
𭏭	fkg
𮦮	fkmeb
𮦮	fkmlb
𮬈	fknwf
𭴳	flsa
𭶀	fmbi
𮙲	fmbuc
𭴰	fmf
𭶇	fmkd
𭴊	fmku
𭴈	fmmi
𭵤	fmre
𭴧	fmrt
𭵅	fmsb
𭵚	fmsb
𮭋	fmvf
𭶆	fnao
𭶛	fnbe
𭕅	fnhe
𭴶	fniw
𭴥	fnkm
𮨔	fnmbc
𭵡	fnnc
𭴞	fohg
𭵘	foie
𭿿	fok
𭴍	fokn
𭴞	fomg
𭶖	fomp
𭴛	fpa
𭴂	fpn
𭵖	fpom
𭴂	fps
𮌐	fqb
𭁑	fqem
𮍨	fqhx
𭑖	fqjb
𭅢	fql
𭴼	fqmb
𮍢	fqmig
𮟵	fqnl
𭅑	fqp
𭜮	fqp
𭵶	fqsk
𭑊	fqy
𭁌	fqyhs
𭑖	fqylb
𭁙	fqyrn
𭴒	frms
𭲲	froe
𭟀	frop
𭵓	frsj
𭵯	fruf
𭵻	fsfi
𮭖	fshaf
𭴻	fsje
𭴏	fsk
𭴵	fsme
𭕈	fsmn
𭴐	fso
𭴴	fsql
𭵯	fsuf
𭶎	ftav
𭶅	ftco
𭴹	ftf
𭵥	fthb
𭵭	fthm
𭶄	ftkt
𭵨	ftlq
𭶂	ftoq
𭵸	ftpb
𭵭	ftqm
𭶩	ftqr
𭴡	ftt
𭵋	ftyt
𭶨	ftyt
𭳿	fu
𭀬	fufhu
𭀨	fuii
𭀴	fujrn
𭀮	fumgt
𭀶	fuynb
𭀴	fuyru
𭑨	fv
𭵲	fvmi
𭵰	fvvu
𭵷	fwf
𭻺	fwjbc
𭴜	fwk
𭻺	fwpbc
𮋒	fwsmm
𭶤	fyag
𭶏	fybb
𭕊	fyhv
𭴤	fyiu
𭵍	fylw
𭕌	fytp
𭶘	fyuc
𭴭	fyws
𭶦	fywv
𭎯	gab
𭐐	gafc
𭎓	gaj
𮤇	gan
𭏾	ganj
𭏁	gbhn
𭐔	gbks
𭏕	gbmm
𭏨	gbmw
𭮰	gbre
𭏛	gbrt
𮝘	gbvj
𭴩	gcf
𭏔	gckn
𮚬	gclst
𮨢	gcmbc
𭎎	gcmj
𮚱	gcnbc
𭜙	gcp
𮚱	gcshc
𮮟	gcwgf
𭔭	gddi
𭐓	gdkni
𭤄	gdok
𭤵	gdyhs
𭿲	gebu
𮮫	gefbg
𮭑	gehaf
𭽸	gehey
𮡑	gehfd
𮡞	gehjg
𭎨	gehk
𭿩	gehmu
𭷮	gehq
𭯛	gehqu
𭚢	geip
𭎚	gej
𮝪	gejwj
𭮾	geksr
𮂐	gemmf
𭯅	geoma
𭐨	geqm
𭇸	ger
𮋻	gesj
𮋾	gesj
𭏉	gew
𭯃	gewd
𭐭	geytr
𭏠	gfbg
𭏩	gfcu
𭐜	gfmbr
𭐘	gfomd
𭣆	gfq
𭎩	ggcg
𭎒	ggdi
𭅶	ggsl
𭎬	ggtj
𭎰	ghdd
𭐇	ghdh
𭷠	ghhq
𭎕	ghiv
𭎝	ghkr
𭎋	ghml
𭎖	ghnb
𭐈	ghok
𭮶	ghre
𮊩	ghtq
𭎾	ghxe
𭏣	ghyb
𭏜	ghye
𭎿	ghyh
𭟯	gi
𭷣	gibhq
𭵴	gif
𭏲	gihv
𭏱	giil
𭣛	gije
𮂑	gimmf
𬼝	gin
𭏖	gitb
𭻈	giwl
𮎙	gjav
𭏧	gjbd
𭎥	gjd
𭽯	gjdhe
𭍾	gje
𭎶	gjir
𭄬	gjks
𭏆	gjlo
𭏎	gjpa
𭎺	gkbl
𮌳	gkbl
𭪃	gkd
𭵴	gkf
𭣛	gkje
𮂑	gkmmf
𭞫	gkp
𭊆	gkr
𭐒	gksr
𭎃	glbu
𭎸	gmbc
𭎑	gmf
𭎠	gmfg
𭎟	gmfr
𭎝	gmkr
𭎅	gmms
𭎞	gmrt
𭍿	gmt
𭎪	gmtt
𭐏	gmwb
𭎹	gmwl
𭐀	gmwm
𭎪	gmyj
𭐄	gnbg
𭩥	gnd
𭶊	gnf
𭏋	gnhd
𭎉	gniy
𭏥	gnof
𭎤	goam
𭾈	gobt
𮚿	gogrr
𮚹	gohbr
𮚳	gohhh
𮛀	goitc
𭎘	goju
𭏒	golk
𮚾	golmr
𮚽	gomgg
𮚺	gomtj
𮚲	gon
𮚻	gonai
𮚵	gonl
𭎂	goo
𮚶	goof
𮚼	gooro
𮧌	goow
𮚴	goqo
𭏹	gorn
𭎌	gos
𮚸	gotc
𮚷	goyk
𭎡	gpa
𭍽	gpd
𭎀	gpp
𭎄	gpsh
𭎧	gpw
𭧳	gqa
𭮽	gqhne
𭎷	gqjt
𭏌	gqkf
𭎜	gqki
𭎫	gqmv
𭎼	grav
𮎚	grav
𭾌	grbt
𭌊	grbuu
𭋠	grfbb
𭋵	grfbq
𭮪	grhne
𭐗	grjf
𭈱	grjkp
𭐖	grmi
𭜶	grmp
𭐙	grni
𮩑	groiv
𭈬	grov
𭇠	grpd
𭊡	grtkr
𭎣	gryo
𭏴	gsja
𭎻	gsko
𭄦	gsks
𭎏	gsll
𭏵	gsmb
𭎛	gsmm
𭏊	gstq
𭅮	gtdej
𭕀	gtdi
𭏦	gtgt
𮙙	gtjej
𭐛	gtjtd
𭏫	gtkt
𭐚	gtmfr
𭏍	gtmh
𭐕	gtno
𮮦	gtok
𭐌	gtst
𭾖	gttwt
𭐎	gtye
𭐆	gubuu
𭎐	gug
𭀦	guhk
𭏐	guju
𭏡	gumg
𭷤	gvvq
𭏬	gwjj
𭏅	gybb
𭏽	gyge
𭎱	gyhl
𭏤	gyhr
𭏸	gylo
𭎔	gymp
𭏟	gypm
𭐁	gypp
𭎳	gyrv
𭏘	gytk
𮭭	gywt
𭏗	gywv
𮩭	haabs
𭽒	haal
𭽛	haaph
𭽾	habt
𮩩	hadoo
𭽟	haehr
𭎊	hag
𭶔	hagk
𭽠	hagsk
𮩨	haheq
𮩯	hahgf
𭽉	hahp
𭽓	hahti
𮩫	haikm
𮩧	haipm
𮩪	hajmo
𭽙	hajtu
𮩱	hajwc
𮅾	haka
𭽔	hakf
𭽐	hakm
𮆣	hakr
𭽌	halll
𭽜	halmy
𮩰	halx
𭐮	hambe
𭽏	hamfj
𭽘	hamlp
𭽋	hammu
𭽆	hamn
𮅘	han
𮆤	hanr
𮆬	hanu
𭽖	haoho
𭽕	hapa
𭽠	haqsk
𭽑	harms
𭽊	haru
𭽇	hasu
𮆭	hate
𮆷	hatf
𭽗	hatq
𮅐	hav
𮩬	hawce
𮮳	hawj
𮮰	hawk
𮮵	hawvj
𭽢	hayed
𭤉	hayeu
𭽍	hayhs
𮕵	hayhv
𮩮	hayle
𭄩	hays
𭨼	hbau
𭨿	hbb
𮗜	hbbuu
𮆁	hbgl
𭘸	hbhab
𭶳	hbhlo
𭨾	hbhnd
𮌙	hbk
𭃥	hbln
𭃭	hbln
𭄕	hbln
𭄙	hbln
𮨣	hbmbc
𮍤	hbmig
𮍲	hbmus
𮆍	hboh
𮉺	hboju
𭣮	hbok
𮅗	hbp
𮉼	hbq
𮅕	hbuk
𮫘	hbuph
𮍳	hbvjv
𮂮	hbwlb
𭠌	hbymu
𮆸	hcbd
𮨠	hcmbc
𮍪	hcmg
𮁨	hcmmf
𮇁	hcwj
𮖶	hcyhv
𮃜	hdafu
𮃦	hdanu
𮃠	hdbac
𮃎	hdbbm
𮅤	hdbm
𮃡	hdecd
𮃪	hdfdw
𮃮	hdgrp
𮃭	hdgrr
𮃚	hdhdf
𮃏	hdheb
𮃞	hdhev
𮂽	hdhey
𮃲	hdhgn
𮃘	hdhjk
𮃙	hdhju
𮂺	hdhke
𮃅	hdhli
𭯄	hdhne
𮂷	hdhnm
𮂶	hdht
𮃴	hdhxc
𮍝	hdhxg
𮃗	hdhxh
𮃝	hdhye
𬼔	hdhyr
𮃷	hdidy
𭫭	hdike
𭫭	hdikk
𮂱	hdiku
𮃶	hdipw
𮃨	hdixp
𮂯	hdj
𮂾	hdjc
𮡏	hdje
𮃔	hdjka
𮃂	hdjlk
𮃟	hdjyj
𮅃	hdk
𮃈	hdkcs
𮃃	hdkf
𮂲	hdki
𮃒	hdlb
𮅧	hdll
𮂴	hdmg
𮂳	hdmmi
𭪋	hdmnr
𬼯	hdn
𮃯	hdnao
𮅸	hdnb
𮃑	hdndt
𮃖	hdnin
𬼏	hdniy
𮂰	hdnl
𭭗	hdno
𮂸	hdno
𮃄	hdnsd
𮃣	hdnwf
𮮑	hdof
𮃍	hdomo
𮮐	hdop
𭞃	hdp
𮃌	hdpfd
𮂵	hdpp
𮃉	hdqkq
𮃇	hdqmb
𮠃	hdrau
𮂻	hdrp
𮅦	hdrs
𮅺	hdse
𮃆	hdsme
𮃤	hdtcg
𮃬	hdtgr
𮩦	hdthu
𮃁	hdtq
𮃬	hdttr
𬼡	hdu
𮃋	hdubq
𮡎	hdv
𮃐	hdvip
𮃕	hdwls
𮃥	hdybb
𮃧	hdycb
𮂿	hdyg
𮃩	hdyhj
𮖈	hdyhv
𮂹	hdyk
𮃊	hdylh
𮃫	hdynb
𮓦	hdypn
𮓦	hdypu
𮃳	hdyro
𮃀	hdyvi
𭽽	hebt
𮮒	hefd
𮆐	hehg
𭐝	hehh
𮆑	heja
𮅔	hemi
𮆨	hemj
𭐞	hemrt
𮟬	henl
𭤂	heok
𮮓	heoyb
𭷵	hephq
𮆆	heqb
𭇪	her
𮆼	herd
𮆒	hesd
𭺰	hetm
𮬻	hfbnd
𮬥	hfhn
𮬷	hfhon
𮭂	hfhsk
𮭄	hfihr
𮭂	hfisk
𮬸	hfjhp
𮬮	hflbu
𭄔	hfln
𮬳	hfmnp
𮭂	hfmsk
𮬦	hfmu
𮭀	hfpfd
𭅿	hfpsl
𮧿	hfpya
𭖽	hfu
𮮞	hfwgf
𮃢	hfya
𭁆	hgc
𮭇	hghaf
𭽡	hghag
𭮵	hghne
𭽚	hgiku
𭄒	hgln
𮀱	hgmr
𮡕	hgnl
𭌳	hgrhr
𮅻	hgsk
𮋋	hgsmm
𮡡	hgstr
𮆟	hgte
𮅋	hh
𮅎	hhbv
𭛗	hhdd
𮆛	hhdj
𮆹	hhdw
𮆮	hhet
𮜴	hhfsm
𮝉	hhjwj
𮜰	hhkm
𭄠	hhks
𭄨	hhks
𮜸	hhlwp
𮜷	hhlws
𮜱	hhmiu
𭼾	hhmk
𮜯	hhmsu
𮃱	hhmwg
𭂫	hhni
𮟫	hhnl
𭱮	hhoe
𮇵	hhofd
𭬲	hhogd
𮜹	hhoir
𮜼	hhomo
𮜹	hhomr
𮜵	hhoq
𮜮	hhpd
𮜶	hhqki
𮆞	hhrj
𮆃	hhro
𮚧	hhslc
𮬺	hhslf
𮜳	hhsmg
𮅝	hhss
𭚘	hht
𮜲	hhtc
𮜺	hhtms
𮜾	hhtrg
𮜻	hhtwv
𬼧	hhu
𮅙	hhxu
𮜽	hhydu
𬼀	hi
𮔭	hiew
𮫣	hiff
𮅍	hifu
𭏢	hig
𮫥	higit
𮔸	higou
𮅇	hihi
𬻯	hihog
𮆠	hiifg
𮫪	hiiop
𭑕	hik
𭑕	hik
𮔒	hiklg
𮔃	hilbi
𮆠	himfg
𮫦	himwd
𮔽	hinlw
𮔏	hiod
𮔺	hioge
𮅟	hioi
𮫨	hioma
𭜍	hip
𮫞	hipa
𮆩	hiptd
𮫫	hisei
𮕅	hisfv
𮅝	hiss
𮕄	hitcp
𮫤	hithu
𮈛	hivif
𮈛	hivkf
𮈛	hivof
𮆯	hixe
𮫟	hiyhv
𬻭	hiyit
𮆿	hiyt
𮆈	hjaf
𮅞	hjbm
𭾜	hjbu
𮭝	hjhaf
𮆳	hjhw
𮅼	hjjl
𮅯	hjjn
𭥬	hjka
𬼌	hjle
𮅶	hjlv
𭐰	hjmbe
𭡍	hjmy
𭙆	hjoq
𭅤	hjpd
𮥜	hjqmc
𮅬	hjsl
𮋉	hjsmm
𮅉	hjt
𬼈	hju
𭐃	hjug
𬼉	hjyv
𭨠	hka
𭑚	hkbb
𭾩	hkbu
𭼽	hkc
𮢒	hkc
𭶓	hkf
𮆂	hkfb
𮬾	hkhaf
𭸫	hkhmr
𮅜	hkho
𭷧	hkhq
𭯣	hkhqu
𮝕	hkjwj
𭷯	hkmhq
𭯡	hkmhu
𮀯	hkmr
𭄐	hkmsh
𬼃	hkn
𮭢	hkpym
𮆓	hkrc
𮅭	hkrd
𮮝	hkwgd
𮅠	hlbr
𮮹	hlgbo
𮆰	hlhj
𭤢	hlhqo
𮓱	hlm
𮅂	hlmu
𮮸	hlnot
𮮶	hlpd
𭈝	hlr
𮆏	hlsw
𮮷	hlvif
𮘃	hlymr
𭠊	hmdhe
𮅁	hmf
𮅍	hmfu
𮅩	hmga
𮅢	hmgh
𮭇	hmhaf
𭐣	hmhe
𮇀	hmii
𭠋	hmkd
𮅹	hmkf
𭺳	hmkni
𭺳	hmknk
𭘑	hmlb
𮆶	hmmf
𭏀	hmmk
𭤟	hmml
𭺵	hmmlk
𮠋	hmnl
𮅱	hmnp
𭺷	hmomo
𭭻	hmqmc
𮆕	hmrj
𭃚	hmshi
𭃚	hmsk
𬼓	hmsmv
𭃚	hmso
𮅝	hmss
𮆪	hmuc
𮃓	hmwg
𮆖	hmwk
𮅥	hmwl
𮆊	hmwt
𭺴	hmyt
𮨮	hnaa
𭪨	hnd
𭪫	hndd
𮨭	hndd
𮆦	hngg
𮨲	hngte
𭂺	hnhgf
𮕕	hnhii
𮨳	hnhlx
𭂵	hnhnu
𭂩	hnj
𮨰	hnjbc
𮨯	hnjnu
𮨪	hnjv
𭂱	hnkb
𭘢	hnlb
𮨩	hnlmi
𬺲	hnm
𮨅	hnmbc
𮨧	hnmg
𮨱	hnnoi
𮨦	hno
𮩄	hnoiv
𭝖	hnp
𮨰	hnpbc
𭂴	hnrhr
𭂴	hnrr
𭂮	hnshi
𭂮	hnsk
𮨵	hnsmh
𭂮	hnso
𮅪	hnsp
𭂹	hnvvu
𮡗	hnwg
𭂬	hny
𮖇	hnyhv
𮨬	hnytj
𮨫	hnyvo
𬼂	ho
𭛲	hoahe
𭶱	hoaph
𭺗	hoau
𭛳	hobqo
𭛡	hobr
𭑡	hodk
𭛶	hoeee
𭜂	hofbk
𭜃	hoffs
𭛟	hogi
𭛰	hogin
𮮧	hogte
𮅓	hoha
𮅴	hohb
𭛻	hohdf
𭜀	hohgs
𭛦	hohio
𭛜	hohj
𭜊	hohrc
𭛭	hohvf
𭶲	hohwj
𭛾	hoiek
𭺘	hoike
𭺘	hoikk
𭛨	hoimo
𮅲	hois
𭚚	hoit
𭜉	hoitc
𭛫	hojbd
𭣠	hoje
𭛮	hojio
𭑕	hok
𭄤	hoksn
𭛥	hoksr
𭜅	hol
𮆀	holb
𮆺	hold
𭛹	holhd
𭄛	holn
𭛹	holod
𭛪	hombu
𭛩	homfg
𭹊	homin
𮕢	hommn
𭛨	hommo
𭮙	homnl
𭛷	homrw
𮅛	homu
𭛱	homwr
𭛞	honin
𭛝	honlm
𭜄	honoe
𮅿	honq
𭛴	hoomb
𭜇	hoomr
𮕣	hoorn
𭛿	hooyk
𭞁	hop
𮅌	hop
𮅅	hopd
𭛧	hoqd
𭛸	hoqhk
𭛯	hoqmb
𮟾	horau
𮅡	hord
𭛠	hore
𭈃	horp
𮅫	hort
𮅵	horu
𭛬	horyo
𭄂	hosh
𭛤	hoshr
𮅄	hosi
𮋹	hosj
𮅄	hosk
𭜁	hotak
𭛽	hotct
𭛼	hothu
𭛣	hotk
𭶹	hotoe
𭜆	hotpd
𮆚	houf
𭶫	howl
𭛢	howo
𭑐	howyi
𭺚	hoybb
𭜈	hoybk
𭛺	hoypb
𭛵	hoyrf
𮆱	hpca
𭎁	hpg
𮅆	hph
𬼒	hphqo
𭏮	hplbk
𬼇	hpo
𮆄	hpog
𮅷	hppu
𮅀	hpsh
𭷴	hqank
𮆉	hqav
𭷚	hqbm
𭷨	hqcip
𮅰	hqdt
𭷛	hqha
𭷞	hqhbt
𭷟	hqheq
𭷗	hqhg
𮅈	hqhp
𮅣	hqig
𭷙	hqihu
𮅳	hqik
𭷡	hqjhq
𭷰	hqjii
𭷭	hqjka
𭷩	hqjph
𭷦	hqkjt
𮅳	hqkk
𮅒	hqku
𭷗	hqmg
𭷜	hqniy
𮆫	hqoc
𮅳	hqok
𮭁	hqokf
𮅖	hqos
𭷖	hqpi
𬼍	hqpq
𭷝	hqpru
𭇤	hqrp
𮅻	hqsk
𭷫	hqsmr
𭷱	hqtak
𮆢	hqtk
𭷓	hqu
𭷷	hqwlg
𮆇	hqws
𮅑	hqyn
𮍾	hrew
𮡐	hrf
𭣂	hrfbq
𮥃	hrheq
𭮫	hrhne
𭍁	hricr
𭍁	hridr
𮎀	hrjji
𮚠	hrlmc
𮠭	hrmcw
𮆎	hrme
𮍴	hrms
𮍼	hroae
𮍶	hroii
𮍶	hroml
𮍵	hron
𮍷	hrsmr
𭚖	hrt
𮍺	hrtmv
𮊶	hrtov
𮍽	hrycn
𮗺	hrymr
𮧺	hryta
𮃵	hryub
𮬧	hshaf
𭠅	hshke
𭠅	hshkk
𭮴	hshne
𮆧	hsho
𭠃	hsike
𭠃	hsikk
𭠄	hsjr
𮂼	hskni
𭠀	hsm
𮅏	hsnh
𭠉	hsoiu
𭠉	hsomu
𭝁	hsp
𭠆	hspru
𭠇	hsrw
𭟿	hss
𭠂	hssr
𭠁	hsyc
𭤁	hsye
𭠈	hsyhs
𮙶	htbuc
𮆵	htbv
𮆗	hter
𮆜	htge
𮕟	hthvo
𮆾	htjr
𮕠	htmnn
𮠁	htnl
𮕝	htsh
𮍛	hubcr
𭯕	hubq
𭀹	hubvk
𮍟	hubwi
𮣄	huc
𮍔	hucsh
𭯓	hudm
𭆵	hudme
𭎗	hug
𭯖	huha
𮫜	huhk
𮍕	huhlo
𭿡	huhsl
𭀵	huhsm
𮍞	huhuj
𮍜	huhxu
𭯙	huiav
𭯚	huice
𭯧	huiev
𮍚	huilp
𭀵	huism
𭀲	hujrr
𭯔	hujt
𮍗	hukm
𭾭	hukn
𭀯	hulln
𭯗	hulln
𭕾	hum
𮍖	humhh
𭕿	humi
𭿋	humnr
𭿡	humsl
𭀵	humsm
𭯟	hunbe
𮅮	hune
𮍙	huooo
𮍘	hupr
𮭩	hupym
𭯞	hurrr
𭀺	huttr
𭿠	huumr
𮡚	huwg
𭀸	huwii
𮮲	huwj
𭀷	huwjc
𭀳	huwjo
𮮱	huwk
𮮴	huwvj
𭯭	huwwg
𮃛	huya
𭣽	huye
𭿊	huyg
𭯯	huyhm
𭿧	huyrn
𭿧	huyru
𭯤	huytg
𭯨	huywf
𮮭	hvbm
𭶜	hvf
𮇂	hvfm
𭂪	hvhn
𮮬	hvng
𭝮	hvp
𮮯	hvrrj
𬼗	hvu
𮮮	hvytr
𭻷	hwbhx
𭻻	hwghi
𭿓	hwgtq
𭻫	hwhe
𭅡	hwhj
𮆘	hwli
𭄁	hwln
𮆋	hwlp
𮆙	hwlv
𭻫	hwme
𭻬	hwnhe
𮅊	hwr
𭻣	hwy
𮍮	hxec
𮍱	hxfc
𮍯	hxhbu
𮍬	hxhc
𮍰	hxhc
𮍦	hxhv
𮍭	hxmc
𮍫	hxnc
𭇦	hxr
𮍧	hxyk
𮆲	hybh
𮎃	hybhn
𮎐	hycor
𮇓	hyfd
𮮧	hygte
𮆡	hygv
𮎌	hyhbu
𮎇	hyhfd
𮎊	hyhio
𮎖	hyjak
𮎑	hyjio
𮎕	hyjmc
𮎓	hyjmi
𮆽	hyjr
𮅨	hykj
𮎅	hykui
𮔇	hylmi
𮎋	hyma
𮎗	hymht
𭽁	hymrt
𭣨	hyok
𮎈	hyom
𮆌	hypc
𮆔	hypc
𮅽	hypm
𮎉	hypt
𮅚	hyq
𮎍	hyqki
𮆥	hyrd
𮎆	hyre
𮎏	hyrhg
𮎎	hyrhr
𮎏	hyrmg
𭈃	hyrp
𮎎	hyrr
𮆻	hyrv
𮆅	hysu
𮎒	hytbc
𮆴	hytf
𮧈	hytlk
𮎔	hytqt
𮆝	hyvn
𮎄	hyyc
𭽂	hyysk
𭥎	ia
𭚐	iabg
𭙵	iabk
𭨼	ibau
𭨿	ibb
𮌛	ibgu
𭶳	ibhlo
𭺼	ibibi
𮌙	ibk
𭄊	ibln
𮌫	ibmiu
𮌾	ibng
𭠌	ibymu
𭚉	icbob
𮮊	icci
𮮈	icd
𮮋	icefh
𮮎	ichid
𮮉	ichv
𬼳	icn
𮮍	icrrf
𮮌	icytc
𭚉	idbob
𮮊	idci
𮮈	idd
𭙽	iddi
𭚅	iddv
𮮋	idefh
𮮎	idhid
𮮉	idhv
𬼳	idn
𭞢	idop
𮮍	idrrf
𮮌	idytc
𭆧	ie
𭙎	ie
𮇾	iefdq
𮭔	iehaf
𭐪	ieice
𭐩	ieihq
𭱉	iemlk
𭜯	iep
𭇪	ier
𭐊	ietcg
𭘁	ievvv
𮂘	ifabk
𮂇	ifahm
𮁲	ifaj
𮂈	ifam
𮂡	ifate
𮂙	ifayf
𮂢	ifbbk
𮁧	ifbbm
𭙱	ifbk
𮂀	ifbmc
𮁧	ifbt
𭙸	ifdq
𮂈	ifhag
𮂥	ifhcq
𮁪	ifhmy
𮁴	ifhon
𮁢	ifhqm
𮁠	ifhqu
𮁩	ifhr
𮂫	ifhwi
𮂈	ifhxg
𮂈	ifhxm
𮂦	ificd
𮂦	ifidd
𮂞	ifigi
𮁥	ifih
𮂅	ifihr
𮁱	ifij
𮁽	ifiok
𮁫	ifjmn
𮁰	ifkb
𮂎	ifkce
𮂎	ifkde
𮁟	ifki
𮁻	ifkkb
𮁿	ifkmf
𮁯	ifkms
𮁬	ifksr
𮁡	iflbu
𮁜	ifln
𮂆	ifmad
𮁭	ifmam
𮁮	ifmbl
𮁭	ifmbm
𮂗	ifmbu
𮂋	ifmhf
𮙖	ifmrt
𭙛	ifmu
𮂌	ifmwd
𮂟	ifmwm
𮂪	ifnac
𮂚	ifnao
𮁾	ifnib
𮂏	ifnii
𮁺	ifnkm
𮂂	ifnkr
𮁺	ifnkv
𮠒	ifnl
𮂖	ifnmb
𮂛	ifnoe
𮁳	ifnsd
𮂁	ifnsr
𮁼	ifohy
𮁣	ifoii
𮁵	ifomg
𮁣	ifoml
𮂊	iforw
𭃡	ifph
𮂒	ifqmc
𮂠	ifqoc
𮁦	ifrc
𮂨	ifsjj
𮂓	iftak
𮂣	iftei
𮂕	iftgt
𮂩	ifwlg
𮂍	ifwlk
𮂜	ifycv
𮂝	ifyhb
𮂝	ifyib
𮂉	ifykh
𮁞	ifym
𮂝	ifymb
𮂔	ifysw
𮁷	ifyvo
𮂧	ifyxf
𭑋	igk
𭚍	igkc
𮠔	ignl
𮩕	igoiv
𭙰	igrc
𭙤	igrt
𭚄	ihdp
𭚇	ihdr
𭚁	ihgv
𭙣	ihjm
𭙖	ihk
𭙍	ihn
𭙔	ihne
𮚥	ihoc
𭙠	ihoe
𭙷	ihoe
𭕋	ihof
𮍏	ihsll
𭆡	ihwj
𭙢	ihxu
𭙩	ihye
𮙏	ihymr
𭩮	iid
𭕄	iih
𭆤	iiie
𭙑	iiii
𮫩	iijd
𭃳	iiln
𬽂	iimmi
𬼰	iipd 
𭅺	iisl
𮋇	iismm
𭙪	iivio
𮕑	iiwli
𭤅	iiye
𭚏	ijji
𭄪	ijks
𭙧	ijsk
𭙥	ijwi
𭙾	ijwv
𭨠	ika
𭩮	ikd
𭆙	ike
𭆞	ike
𭣔	ike
𮝕	ikjwj
𭚈	ikma
𭙚	ikn
𮀈	ikomr
𭞑	ikp
𭚋	ikq
𭷿	iksmr
𭙓	ikui
𮮝	ikwgf
𭙘	ilbk
𮔕	illmi
𮖒	ilov
𭙙	ilp
𭚀	ilpe
𭚊	ilpf
𭈝	ilr
𭨘	ilwv
𭟮	im
𭂠	imana
𭂣	imani
𭂦	imbmp
𭂚	imcmt
𭂡	imcwa
𭠊	imdhe
𭂜	imdoe
𭨐	imfa
𭂝	imfbb
𭂋	imgr
𭂒	imhna
𭂖	imhni
𭂛	imhrf
𭂢	imirp
𭠋	imkd
𭂇	imks
𭂨	imlib
𭘀	imlil
𭙜	imlk
𭂟	imlmc
𭂌	imlmi
𮍐	imlns
𭂧	immbi
𭂆	immvs
𮗫	imnbg
𭂕	imnme
𭂘	imnob
𭙻	imnv
𭂙	imoge
𭂤	imoim
𭂤	imolm
𭂏	imoyt
𬼰	impd
𭂐	imphr
𭂉	impkk
𮍒	imsll
𭂊	imsp
𭆚	imt
𭂥	imtag
𭂚	imtct
𭂎	imtq
𭂈	imu
𭙪	imvio
𭂕	imvne
𭂞	imycb
𭂑	imyfe
𭂍	imymp
𭂓	imyrd
𭂗	imysd
𭂔	imysy
𭟵	inbg
𭙒	ind
𭯼	ineg
𭙡	inib
𭆝	inii
𭙹	inlm
𭃧	inln
𭙗	inm
𬻺	inn
𭙏	inn
𭚥	ins
𮧗	intlj
𬻿	io
𭙦	ioae
𭁊	ioc
𭩮	iod
𭙶	iogb
𭚑	iogb
𭙳	iogg
𭙲	iogr
𭙞	ioir
𭆣	ioll
𭄉	ioln
𭙞	iomr
𬼛	ion
𭙐	ion
𭙟	ioog
𭯎	iopp
𭙝	iowy
𭏙	ipg
𮭗	iphaf
𭚠	iphi
𮭺	iphui
𭚣	ipmca
𮭳	ipmgi
𬻓	ipmy
𮭵	ipnau
𮟪	ipnl
𭏿	ipoog
𭙮	ippr
𮭲	ipr
𭚡	ips
𮭸	iptgk
𭗎	ipu
𭙕	iq
𭷬	iqgr
𭷲	iqihr
𭷢	iqjr
𭚍	iqkc
𭣒	iqomd
𭷪	iqomr
𬼪	iqon
𭢽	iqpd
𮜟	iqvo
𭱡	ire
𭟻	irmg
𭙴	irrj
𮩻	irsf
𭠅	ishke
𭠅	ishkk
𭠃	isike
𭠃	isikk
𭠄	isjr
𭠀	ism
𮙢	ismso
𭠉	isoiu
𭠉	isomu
𭠆	ispru
𭠇	isrw
𭟿	iss
𭠂	issr
𭙼	isuf
𭚃	isva
𭅳	isy
𭠁	isyc
𭠈	isyhs
𭙯	itbc
𭚞	itbwi
𭙬	itgi
𭙭	ithm
𭙫	itjv
𭙭	itqm
𭚎	itqq
𮚊	itsc
𮭱	itsf
𭙺	ittb
𭙿	itwb
𮬯	iuhaf
𭿀	ivbu
𮙉	ivdip
𮙋	ivjkr
𮙊	ivnlp
𮎘	ivofj
𭚆	iwfl
𭚌	iwlg
𭯇	iwyi
𭚂	iybp
𭙨	iyjy
𭟰	iylm
𭟴	iyma
𮭴	iypv
𭶞	jacf
𭓡	jau
𭧢	jbamo
𬻧	jbbm
𮣣	jbc
𭒲	jbcv
𭓸	jbmb
𭁢	jbmm
𮁸	jbmmf
𮕛	jbmri
𮠈	jbnl
𭅥	jbno
𮈖	jbvif
𭔊	jcai
𮄍	jcalo
𮙹	jcbuc
𮄋	jcbw
𮄝	jcebe
𮄇	jcejd
𮄠	jcesb
𮄁	jcgwu
𮃹	jchlo
𮄘	jchob
𮄎	jchoe
𮃸	jchp
𮄒	jchwn
𮃼	jchx
𮄚	jcifu
𮄖	jcjmp
𮁶	jclml
𭄗	jcln
𮃺	jcmbm
𮄞	jcmfb
𮄚	jcmfu
𮄌	jcmgd
𮃾	jcnkm
𮃾	jcnkv
𮃿	jcoam
𮄂	jcogg
𮄊	jcose
𮄆	jcpjd
𮄄	jcqmb
𮄣	jcqmp
𮃻	jcrlr
𮃽	jcrmh
𮄉	jcrmn
𮄟	jcrmu
𮄛	jcrnf
𮄢	jcrnf
𮄅	jcrwu
𮄀	jcsme
𮄤	jctjr
𮄈	jctmo
𮄡	jcvmd
𮄕	jcvmh
𮄥	jcvmn
𮄔	jcvmr
𮄦	jcvmu
𮄙	jcvmv
𮄑	jcybb
𮄓	jcyij
𮄗	jcyru
𮧼	jcyta
𮄜	jcyto
𭓖	jdbms
𭔢	jdfu
𭓆	jdino
𭑓	jdki
𭓙	jdlga
𮁤	jdmmf
𮭾	jebhx
𮝥	jefb
𮭽	jeff
𭏳	jeg
𭓼	jegi
𭑘	jek
𭓻	jeph
𭣘	jepru
𮭿	jepuu
𭣗	jerc
𮜋	jeryo
𮮀	jethb
𮮀	jetmb
𮮁	jetwa
𭥂	jeyhs
𮭈	jfhaf
𭮹	jfhne
𭓪	jfmu
𮥹	jfog
𭝜	jfqp
𭔵	jgdi
𭃸	jgln
𬺱	jh
𭺏	jhbi
𭓫	jhbu
𭓦	jhd
𭔎	jhdp
𭜰	jhep
𮄐	jhhkr
𭓯	jhjr
𭓧	jhke
𭄖	jhln
𭅠	jhn
𭓹	jhoo
𭔜	jhqd
𭔉	jhui
𭩩	jhvh
𭔀	jhyu
𮚂	jibuc
𮧇	jilmy
𭕃	jimgg
𭤈	jiok
𭮻	jire
𮝧	jjang
𮝚	jjbtu
𭃿	jjcsh
𮝌	jjdhe
𭓢	jje
𮝐	jjhjr
𮝍	jjihs
𮝊	jjine
𮝩	jjiod
𭅪	jjkcs
𮝔	jjkjt
𮋙	jjkmm
𮝎	jjkms
𮜿	jjkni
𭓮	jjkp
𮝢	jjlib
𮝬	jjmdm
𮝭	jjmfb
𮝓	jjmlk
𮝗	jjmno
𮝣	jjmrb
𮝒	jjmrt
𮝆	jjmym
𮝅	jjnl
𮝨	jjogd
𮝂	jjoj
𮍿	jjomr
𮝑	jjop
𮋖	jjorm
𭅓	jjp
𭅎	jjpru
𮝠	jjqkw
𮝰	jjqoc
𮝇	jjre
𮝞	jjrsm
𮝡	jjsjp
𮝀	jjsk
𮝙	jjsmv
𮝝	jjsug
𮝖	jjta
𮝮	jjtjc
𮝮	jjtpc
𮊪	jjtq
𮝛	jjvrb
𮝟	jjvvw
𮝯	jjwgg
𮝜	jjwhd
𮝫	jjybb
𮝄	jjyc
𮝱	jjymu
𮓫	jjypn
𮝤	jjypn
𮓫	jjypu
𮝤	jjypu
𭓰	jkbq
𭹯	jkhng
𭓤	jklb
𭤎	jkmdt
𭆓	jkmms
𭤧	jks
𮋝	jkyma
𭓿	jlac
𬻫	jlbm
𮥴	jle
𬺿	jli
𭔡	jljy
𭄡	jlks
𭺫	jlmm
𬼞	jlp
𭔑	jlpu
𭄇	jlsh
𭓱	jlwi
𭔔	jlyv
𮗗	jmbuu
𮄃	jmfq
𭔟	jmgc
𭓴	jmgn
𭔒	jmhqi
𮖊	jmhv
𭅬	jmjbf
𭄲	jmks
𭝛	jmmp
𭭣	jmoi
𭅨	jmoog
𮄏	jmqmv
𭔇	jmsp
𭔌	jmua
𭔆	jmue
𭓾	jmuk
𭓟	jmvh
𭔈	jmvio
𬺰	jn
𭓲	jnbg
𭓲	jnbq
𭔨	jnhdv
𭔦	jnher
𭓩	jnip
𭓬	jniq
𮭼	jnjnu
𭄑	jnln
𭔤	jnnsd
𭔙	jnor
𭓽	jnou
𭟋	jnp
𭔞	jnpd
𮮂	jnthj
𭾅	jnut
𭤪	jnyhs
𭔧	jnyok
𭔥	jnysf
𭔁	joak
𭓭	jod
𭱁	joe
𭔓	jogf
𭓠	joj
𮭻	joni
𭫈	jooo
𭝠	jop
𭔍	joyk
𭠍	jp
𭾀	jpbt
𭑿	jpcv
𮋜	jpgr
𮬲	jphaf
𭔋	jphr
𭓺	jpjd
𭃰	jpln
𮨥	jpmbc
𮋛	jpmnr
𮋞	jprjd
𭅷	jpsl
𮋍	jpsmm
𭔝	jptb
𮧹	jpyta
𮍂	jrbao
𭩀	jrbb
𮌔	jrbb
𭋛	jrbtv
𮗎	jrbuu
𮙐	jrcor
𭐋	jrg
𭔠	jrjcm
𭃺	jrln
𭔛	jrmvm
𮚍	jrrbc
𭮼	jrre
𭌌	jrrv
𭔄	jsbn
𭵉	jsf
𭃄	jsh
𮨗	jsmbc
𮮪	jtbe
𭔗	jtbp
𮋐	jtcm
𭓵	jtd
𭔣	jthb
𬻂	jtj
𭓣	jtm
𭓨	jtmm
𭔕	jtwk
𭓞	ju
𭆷	jue
𭄋	juln
𭄌	jush
𭃔	jushi
𭃔	jusk
𮋃	jusmm
𭃔	juso
𭴣	jvf
𮭍	jvhaf
𭅬	jvjbf
𭣞	jvje
𭄧	jvks
𭚨	jvks
𭔅	jvma
𭔖	jvmg
𭔘	jvmm
𭔏	jvmr
𭅨	jvoog
𬻒	jvs
𮪂	jvsqf
𭔐	jvvd
𭴠	jvvf
𬻍	jwlh
𬻌	jwlo
𭻿	jwyo
𭓶	jyaj
𭔚	jygv
𭔂	jykh
𭓷	jylh
𭓥	jyr
𭓳	jytn
𭔃	jytr
𭼪	kabi
𭼩	kabk
𭼶	kakg
𮎞	kanau
𭑥	kanin
𭼡	kawe
𭘯	kbbb
𭼻	kbcg
𭼹	kbcn
𭘨	kbcnh
𭘟	kbive
𭁤	kbkb
𭁬	kbkb
𭘹	kbter
𭼮	kbuf
𭣷	kbye
𮙺	kcbuc
𭪬	kcfmu
𭪎	kckr
𮠡	kcmcw
𭣱	kcok
𭫇	kcoos
𭪍	kcymy
𭸒	kdbt
𭪬	kdfmu
𭫹	kdher
𭪎	kdkr
𭣱	kdok
𭩭	kdol
𭫇	kdoos
𭪍	kdymy
𭼖	kea
𭯂	kebd
𭼥	keii
𭯀	kejd
𭼴	kesb
𭼷	keym
𭼎	kfbs
𭼈	kha
𭸛	khabu
𭸚	khatc
𭸴	khbce
𭷻	khbhn
𭸏	khbmb
𭸜	khbso
𭸓	khdd
𭼜	khdt
𭸥	khfhf
𭸦	khfqt
𭼋	khgc
𬼑	khgi
𭸩	khgov
𭸎	khhap
𭸞	khhje
𭸬	khhoe
𭷽	khhq
𭸀	khih
𭸉	khiqo
𭸲	khjad
𭷹	khjk
𭸇	khjnd
𭸡	khkaf
𭸍	khlau
𭸤	khliu
𭸄	khmbl
𭸔	khmkh
𭷸	khmn
𭸊	khmoo
𭸠	khnkq
𭸆	khobo
𭼼	khok
𭷼	kholl
𭸝	khomk
𭸗	khptd
𭸌	khqme
𭸅	khrr
𭸑	khsip
𭸑	khskp
𭸑	khsop
𭸐	khsql
𭸢	khstr
𭸨	khtcl
𭸧	khthd
𭸳	khthf
𭸙	khtih
𭸘	khtmd
𭸯	khuhf
𭸂	khuni
𭸖	khvvw
𮭞	khwif
𭸱	khwlf
𭸰	khwlp
𭸈	khyhv
𭷾	khyj
𭸃	khyk
𭷺	khymu
𭸕	khyok
𭸟	khytr
𭫅	kid
𭆠	kiki
𭄣	kiks
𬻨	kimy
𭁘	kiyc
𭼔	kjbm
𭼔	kjuv
𬼆	kk
𭼛	kkhi
𭟢	kkp
𮭪	kkpym
𭼤	klde
𭼢	kllp
𭼵	kmbe
𭼠	kmbm
𭼠	kmbs
𭑃	kmd
𭼰	kmdm
𭼱	kmfi
𭼆	kmg
𭘉	kmhxu
𭝍	kmmp
𭼏	kmmv
𭼨	kmni
𭑗	kmwg
𭼗	kmwg
𭼬	knbe
𭼉	kniu
𭑂	knk
𭼭	knli
𮨎	knmbc
𮁝	knmmf
𭼦	knoi
𭇍	knrp
𬼣	knyk
𭑣	koga
𭼫	kogd
𭑝	kogg
𭼘	kohu
𭆜	koi
𭼒	koir
𭼯	kokg
𭼌	kol
𭼑	komc
𭹎	komgi
𭼒	komr
𭼇	kop
𮋄	kosmm
𭼳	kotq
𭼙	kpkp
𭼚	kpnp
𮝸	kqhju
𮝴	kqhvo
𮝷	kqjto
𭼓	kqmb
𮝵	kqmbl
𮝶	kqomc
𮝺	kqtav
𮝹	kqwlv
𮝳	kqyc
𭈸	krbbm
𭽿	krbt
𮈓	krbvf
𭴖	krf
𭄢	krhi
𭀢	krhu
𮝋	krjwj
𭄻	krqyt
𮟶	krrau
𮜈	krrme
𭖔	kru
𭑅	ksb
𭶕	ksf
𭄱	ksrho
𭄷	kstct
𭼟	kstr
𮈋	ksvif
𭸭	kswla
𭼊	ktc
𭼸	ktci
𭼞	ktgp
𮥽	kuog
𭼧	kvis
𬼵	kvrr
𭼺	kvuc
𭼍	kvvd
𮯏	kvymu
𭼐	kwd
𭑠	kwjc
𭼝	kycr
𭼣	kyhj
𭼲	kypg
𭼕	kysk
𭨡	lalk
𬻸	lamh
𭴷	lapf
𭘩	lbamh
𭘱	lbbbb
𭘼	lbbot
𭘠	lbbuu
𮗓	lbbuu
𮗖	lbbuu
𭘮	lbdmb
𭘜	lbfmu
𭎽	lbg
𭘫	lbhah
𭘞	lbher
𮌽	lbhgr
𮌽	lbhqr
𭘰	lbibi
𭘚	lbir
𭘕	lbjd
𭘝	lbjhp
𭘻	lbjnt
𭘙	lbjp
𭘖	lbjr
𭘛	lbkf
𭘴	lblde
𭘵	lblmc
𭘓	lbmku
𮌄	lbml
𭓇	lbnd
𭓕	lbnd
𭓘	lbnd
𮌇	lbno
𭘘	lboii
𭘔	lboj
𭘘	lboml
𭘡	lbrhg
𭘡	lbrmg
𮌱	lbtc
𭘤	lbtgn
𭘲	lbtmj
𮕲	lbu
𭘥	lbvvw
𭘦	lbvvw
𭘪	lbwb
𭘗	lbwe
𭘶	lbypo
𭘭	lbyrn
𭅁	lcks
𭢅	lcq
𮘤	lcymr
𮖕	ldbm
𮕧	le
𮔉	leci
𭬢	led
𭻭	lew
𮖫	lfbb
𮌃	lgbm
𭮳	lghne
𮖻	lgni
𮖱	lgro
𭾆	lhbt
𮕼	lhbu
𮖙	lhde
𮖝	lhdf
𮖴	lhgi
𮖵	lhoe
𭝘	lhp
𮕭	lht
𮖜	lhxo
𮔙	liab
𮔫	liafu
𮔎	libbm
𮗘	libuu
𮕒	licii
𮔿	licwa
𮔗	lidbn
𮔆	lihbt
𮔹	lihoi
𮕏	lihop
𮔑	lihru
𮕯	lihu
𮔖	liice
𮓼	liimo
𮔦	liite
𮔪	lijbc
𮕚	lijbu
𮔁	lijks
𮔾	lijmn
𮔡	likit
𮓻	lilbu
𮓳	lilis
𮖩	lilr
𮕍	lilvk
𮔻	limbi
𮔩	limgk
𮓺	limms
𮔊	limob
𮔨	limti
𮕈	limue
𮔠	limwg
𮓶	lin
𮔛	linai
𮔅	linbo
𮔲	linld
𮕖	linmb
𮔤	linsp
𮔄	liod
𮕐	liogb
𮔈	liohu
𮔣	lioiv
𮔐	liomc
𭜫	lip
𮔪	lipbc
𮓲	lipn
𮓲	lips
𮓽	lipt
𮔷	liqjm
𮔷	liqjs
𮔋	liqll
𮔋	liqln
𮔘	liqmv
𮕌	liqoc
𮔵	lirrs
𮓷	liru
𮓴	lis
𮔱	lisfb
𮔔	lishu
𮓹	lisk
𮕇	lisod
𮔟	lissd
𮔚	litbs
𮕓	litei
𮔴	litib
𮕘	litob
𮔂	litsl
𮔌	liuau
𮔬	livmi
𮓿	liw
𮕋	liwlo
𮔢	liwpp
𮔥	liyaf
𮕙	liyhs
𮔜	liyhv
𮔍	liyma
𮕃	liymf
𮕂	liymw
𮕆	liyto
𮔝	liytq
𮔮	liyub
𮕗	liyvn
𮔶	liywi
𮌆	ljbl
𬺺	ljs
𮕨	lk
𭂰	lkhn
𮝈	lkjwj
𮖆	lkkb
𭆾	lkn
𮮤	lknru
𭣥	lkok
𭷉	lld
𭆪	lle
𮖃	lleg
𮬱	llhaf
𭷎	llhii
𭸁	llik
𭻄	lllbu
𮙜	llmso
𮕥	lln
𭧁	llnhx
𭷊	lloii
𭷌	llolw
𭷊	lloml
𮌂	llqu
𭷋	llrvp
𮨈	llsc
𮣻	llsmv
𮖌	llst
𭦘	lltt
𭦘	llyjj
𮖲	lmbb
𮖗	lmbc
𭾋	lmbt
𮗘	lmbuu
𭴘	lmf
𮓰	lmi
𭣖	lmje
𮖂	lmkr
𭁉	lmmc
𮖳	lmmi
𭤏	lmmjk
𮖰	lmml
𬻳	lmn
𭤏	lmnjk
𮖁	lmob
𭣣	lmok
𭀡	lmsp
𭑲	lmv
𮕰	lmvn
𮫔	lnfqu
𮕿	lnir
𬽀	lnmmi
𮍌	lnns
𮕾	lobm
𮖤	loge
𮕶	lolb
𮖉	loog
𮕬	lop
𮕴	lopd
𮕽	lopj
𮧤	lotje
𭖲	lou
𭥣	lpa
𮮨	lpgte
𭃨	lph
𭤥	lphml
𭇑	lpr
𮖣	lpub
𭁇	lqmc
𭁈	lqmc
𭾏	lrbt
𮖹	lrij
𮖹	lrji
𮖅	lrmk
𮧰	lrmvj
𮖸	lrri
𮖅	lrvk
𮕸	lrvp
𭓗	lsbnd
𮍍	lse
𮤳	lsem
𮤷	lsetc
𮤭	lsf
𮤰	lsfh
𭍻	lsg
𮤬	lsg
𭛖	lshb
𭮯	lshne
𮤵	lshog
𮤶	lsjcm
𬼕	lslc
𮤱	lslmp
𮖮	lsmh
𮊹	lsmm
𮤫	lsmn
𮤯	lsob
𮤲	lsph
𮖍	lsql
𭆬	lsse
𮫕	lssqf
𮤸	lswgf
𮖪	ltak
𮖷	ltcd
𮖯	ltgr
𮖺	ltja
𮤴	ltmdm
𮖏	ltop
𮖯	lttr
𮖡	ltwk
𮖨	ltxc
𮕤	lu
𭦳	lua
𭤋	lvike
𭤋	lvikk
𭒰	lviov
𭒰	lvmov
𮖓	lvvw
𭾊	lwbt
𮕳	lwc
𭾉	lwiot
𭺽	lwnh
𮖘	lwpp
𭘋	lwru
𭘌	lwru
𮖾	lwrw
𮖧	lybs
𮖼	lybu
𮖦	lyhr
𮕪	lyhv
𮧆	lylbk
𮧄	lymmi
𮀦	lymr
𮖽	lymu
𭣻	lyok
𮖞	lyrn
𮖞	lyru
𮖀	lyvo
𮧅	lyw
𭆕	mabk
𭤍	mabmk
𭂾	macv
𭮩	mahne
𭆔	mahr
𭽎	maht
𭆴	majse
𭽈	malm
𬻐	mamn
𭜩	mamp
𭆂	man
𭭒	mano
𭝡	manp
𭦨	mashr
𭽝	mawd
𮦠	mbajd
𮦗	mban
𭨼	mbau
𭨿	mbb
𮦡	mbbou
𮦋	mbbu
𮦒	mbbuc
𭆎	mbci
𭫒	mbd
𭽹	mbdhe
𮦕	mbdoo
𮡣	mbdug
𭁥	mbe
𮦬	mbeak
𮦶	mbeau
𮦺	mbedh
𮦣	mbehr
𮦫	mbeib
𮦛	mbeie
𮦨	mbeko
𮦵	mbemi
𮦩	mbemv
𮧂	mbenf
𮦧	mbeng
𮦲	mbenk
𮦹	mbetc
𮦴	mbete
𮦼	mbetf
𮦽	mbetv
𮦪	mbews
𮦿	mbeyg
𮧁	mbeyp
𮦏	mbeyv
𮦉	mbf
𮋢	mbfhu
𮦐	mbgd
𭶳	mbhlo
𮦘	mbhpa
𭸣	mbik
𭸮	mbik
𮦥	mbing
𮦚	mbjmi
𮌙	mbk
𮦦	mbkhg
𮦅	mblis
𭃴	mbln
𮦷	mbmdm
𮦤	mbmge
𮦜	mbmgi
𮦜	mbmgl
𮦖	mbmii
𭁡	mbmm
𮦊	mbmmr
𮦔	mbmpm
𮭹	mbmtc
𮧎	mbmwl
𮦍	mbnil
𮟸	mbnl
𮦈	mbob
𮦓	mbobu
𮦎	mbofj
𮦙	mbojk
𭞨	mbp
𮦑	mbrb
𮦾	mbsjb
𮕜	mbt
𮦝	mbtkr
𮦟	mbwf
𮦭	mbwlc
𭠌	mbymu
𮦌	mbyr
𮦢	mbytk
𭦚	mca
𭮷	mchne
𭯦	mchqu
𭄘	mcln
𭭈	mcno
𭯋	mcpp
𭘎	mcsu
𭻍	mcw
𬻕	mcwm
𭫔	mdd
𮧶	mdyta
𭣕	meh
𭐲	mehdw
𮦸	membi
𭯠	memhu
𭄮	memks
𭭓	meno
𭝸	mep
𭇪	mer
𭴃	mf
𮂘	mfabk
𮂈	mfag
𮂇	mfahm
𮁲	mfaj
𮂈	mfam
𮂡	mfate
𮂙	mfayf
𮂢	mfbbk
𮁧	mfbbm
𮂀	mfbmc
𭁣	mfbq
𮁧	mfbt
𬻛	mfgi
𮂥	mfhcq
𭛔	mfhhh
𭶶	mfhlo
𮁪	mfhmy
𮁴	mfhon
𮁢	mfhqm
𭯒	mfhqu
𮁠	mfhqu
𮁩	mfhr
𮂫	mfhwi
𮂈	mfhxg
𮂈	mfhxm
𮂦	mficd
𮂦	mfidd
𮂞	mfigi
𮁥	mfih
𮂅	mfihr
𮁱	mfij
𮁽	mfiok
𮂧	mfixf
𮁫	mfjmn
𮁰	mfkb
𮂎	mfkce
𭑦	mfkcs
𮂎	mfkde
𮁟	mfki
𮁻	mfkkb
𮁿	mfkmf
𮁯	mfkms
𮁬	mfksr
𮁡	mflbu
𮔞	mflmi
𮁜	mfln
𮂆	mfmad
𮁭	mfmam
𮁮	mfmbl
𮁭	mfmbm
𮂗	mfmbu
𭆖	mfmc
𮂋	mfmhf
𮙛	mfmo
𮂌	mfmwd
𮂟	mfmwm
𮂪	mfnac
𮂚	mfnao
𮁾	mfnib
𮂏	mfnii
𮁺	mfnkm
𮂂	mfnkr
𮁺	mfnkv
𮂖	mfnmb
𮂛	mfnoe
𮁳	mfnsd
𮂁	mfnsr
𮁼	mfohy
𮁣	mfoii
𮁵	mfomg
𮁣	mfoml
𮂊	mforw
𮂒	mfqmc
𮂠	mfqoc
𮁦	mfrc
𮂨	mfsjj
𮂓	mftak
𮂣	mftei
𮂕	mftgt
𮂩	mfwlg
𮂍	mfwlk
𮂜	mfycv
𮂝	mfyhb
𮂝	mfyib
𮂉	mfykh
𮁞	mfym
𮂝	mfymb
𮂔	mfysw
𮁷	mfyvo
𭨞	mga
𭹕	mgaa
𭺔	mgaau
𭹺	mgank
𭹨	mgapv
𭺔	mgauu
𭺄	mgaws
𭺆	mgbbe
𭹅	mgbbm
𭹑	mgbdi
𭹘	mgbfd
𭹠	mgbmg
𭹝	mgbmi
𭹣	mgbmo
𭹝	mgbti
𭺕	mgbuu
𭺒	mgbvd
𮦱	mgcms
𭺌	mgdec
𭹢	mgede
𭹓	mgeyk
𭶗	mgf
𭹈	mgfk
𭹗	mgfw
𭹿	mgfwf
𭹌	mggil
𭹍	mgglc
𭹶	mggrr
𭸸	mghe
𮍡	mghe
𭹇	mgheq
𭹏	mghfd
𭸺	mghk
𭹳	mghnd
𭺊	mghne
𭺇	mghnp
𭺉	mghok
𭺎	mghon
𭸶	mghqu
𭹩	mghrg
𭹁	mghvi
𭹁	mghvm
𭸻	mghvp
𭹻	mghwo
𭹉	mghx
𭹮	mgifr
𭸿	mgih
𮍠	mgije
𭺓	mgiop
𭹽	mgjcf
𭹾	mgjcg
𭹸	mgjcm
𭸷	mgje
𭹋	mgjhp
𭹂	mgjp
𭺋	mgjpi
𭹹	mgjwv
𭹲	mglll
𭹫	mgmbc
𭺑	mgmbg
𭹄	mgmbl
𭺀	mgmbu
𭸸	mgme
𭹮	mgmfr
𭹥	mgmhn
𮦁	mgmjs
𭹚	mgmng
𭹷	mgmsd
𭺅	mgnbq
𭹵	mgnod
𭹒	mgnor
𭹀	mgof
𭹆	mgohg
𭹞	mgokg
𭹐	mgokr
𭺈	mgomf
𭹆	mgomg
𭸹	mgomm
𭘆	mgoo
𭌐	mgphp
𭣑	mgphp
𭹟	mgpou
𮍣	mgqkq
𭹙	mgqmv
𭺂	mgrbr
𭸵	mgsh
𭹔	mgsme
𭸾	mgss
𭺁	mgtdq
𭹴	mgtge
𭹤	mgtlj
𭺃	mgtrj
𭹼	mgtwi
𭺖	mgtye
𭹛	mgtys
𭹧	mguhr
𭒁	mgv
𭹭	mgwce
𭺍	mgwfk
𭹜	mgwln
𭯈	mgwyi
𭹃	mgwyi
𭹱	mgyhr
𭺐	mgykc
𭹡	mgykf
𮘻	mgymr
𭹪	mgyos
𭹦	mgypm
𭹰	mgypn
𭆅	mhau
𮗍	mhbuu
𮢝	mhc
𭶸	mhdo
𭘇	mher
𭴪	mhf
𮓙	mhhn
𮓜	mhlb
𮙟	mhmso
𬻃	mhnl
𭕋	mhof
𭷒	mhoii
𭜹	mhp
𮓘	mhp
𭅍	mhpkk
𭇢	mhr
𮓥	mhrmk
𭷐	mhrms
𮓥	mhrvk
𮓡	mhtc
𭚗	mhti
𭾐	mhwbt
𮡘	mhwg
𭞐	mhwp
𭷑	mhyck
𭷏	mhyk
𮗿	mhymr
𭟺	mia
𭨨	mib
𭽻	midhe
𭎆	miig
𭅀	miks
𮨀	mimbc
𮨇	mimbc
𭣪	miok
𮋔	mismm
𬽁	miymp
𮧀	miymu
𭘿	mjgi
𭙃	mjiav
𭆄	mjsn
𭙁	mjyk
𭙀	mjyr
𭨠	mka
𭑙	mkan
𭾹	mkbu
𮚌	mkbuc
𭕇	mkf
𭧣	mkfa
𭷥	mkhq
𮝕	mkjwj
𭑤	mkk
𭄯	mkks
𮤮	mklis
𭄏	mkln
𭆆	mkm
𮦇	mkmeb
𭑈	mkmk
𮦇	mkmlb
𭑆	mkmmi
𭑇	mkmmi
𭆑	mkmms
𮁑	mkmr
𬻊	mkmy
𭣼	mkmym
𭺜	mknu
𭄟	mks
𭕲	mkshu
𭒀	mkv
𮮝	mkwgf
𮦄	mlbf
𮦆	mlbo
𭺪	mllm
𬻇	mllw
𮀰	mlmr
𭀟	mlou
𭜺	mlp
𭈝	mlr
𮋔	mlsmm
𭗻	mlum
𬺶	mlvn
𮓞	mlwb
𮓠	mlwm
𭀝	mlyu
𭭪	mmal
𮭷	mmbbf
𮭶	mmbbi
𮗒	mmbuu
𭠊	mmdhe
𭻑	mmew
𭱷	mmews
𮭙	mmhaf
𭐠	mmhe
𬻪	mmhqi
𭭯	mmhqi
𭭮	mmhsb
𭴉	mmif
𭁪	mmiq
𭭹	mmirp
𭭮	mmisb
𬼾	mmit
𭆐	mmje
𭠋	mmkd
𬼽	mml
𭭫	mmmnr
𭭮	mmmsb
𮟷	mmnl
𭘣	mmrlb
𮍎	mmsll
𭜋	mmsp
𭭸	mmtav
𬻜	mmtm
𭘄	mmu
𮝾	mmv
𭘃	mmy
𭤖	mmyk
𭮣	mnana
𭩶	mnd
𭪴	mnd
𭔫	mndi
𭮞	mnelm
𭴀	mnf
𭮋	mnfmu
𭮒	mnglc
𭺞	mngr
𭇏	mnher
𭮍	mnhie
𭮡	mnhkb
𭤡	mnhml
𭑔	mnhqo
𭮄	mnii
𬻣	mnjch
𭆐	mnje
𭮂	mnje
𭮏	mnjhp
𭮉	mnjlm
𭮟	mnjwf
𭺟	mnlmi
𭮇	mnlwl
𭮥	mnmbb
𭮤	mnmfb
𭮊	mnmii
𬻄	mnmnn
𭮗	mnmpm
𭮠	mnmwj
𬻖	mnnau
𭺢	mnnib
𭮖	mnnoo
𬻗	mnnsd
𭮛	mnnws
𭮕	mnoir
𭣤	mnok
𭺝	mnoll
𭮘	mnolm
𭮕	mnomr
𭭽	mnp
𬺼	mnpd
𭮌	mnpuk
𭠧	mnq
𭮝	mnrcu
𭮈	mnre
𭮀	mnru
𭮁	mnru
𭃖	mnsh
𭮅	mnsk
𭅵	mnsl
𭮦	mntaf
𭮎	mntt
𭮑	mnvif
𭮔	mnwg
𭺛	mny
𬻅	mnyc
𭮐	mnyii
𭮃	mnyj
𭮎	mnyjj
𭮢	mnyka
𭺣	mnyoj
𭺥	mnypo
𭮆	mnyr
𮙣	moahu
𭁊	moc
𭴺	mof
𭆘	mofc
𭏪	mog
𬼿	mom
𮙤	momfu
𭸽	momg
𭆀	mon
𭏞	mooog
𭯎	mopp
𭆈	movf
𭮓	mpbt
𭘅	mpi
𭘅	mpm
𭚟	mpm
𮠑	mpnl
𭤓	mpok
𭜨	mpp
𬻔	mpsi
𭞔	mpuu
𭻏	mpw
𭪕	mqd
𭆌	mqik
𭆇	mqjo
𭆌	mqkk
𭠠	mqmqi
𭆌	mqok
𬺵	mqs
𭄓	mrahn
𮀧	mrcso
𭊣	mrdhe
𮁍	mregj
𮀿	mrfog
𮀞	mrhds
𮀐	mrhhl
𮀙	mrhkr
𮀖	mrhon
𮁇	mrhor
𮀹	mrhuk
𮁕	mrhxc
𮀝	mrhxh
𮀵	mrikd
𮀕	mrir
𮁎	mrjcg
𮁗	mrjji
𮀓	mrjmn
𮀩	mrjrr
𮀚	mrjru
𮀳	mrjsg
𮀗	mrjym
𮀋	mrk
𮀾	mrkob
𮁐	mrmbd
𮀽	mrmbl
𮁋	mrmbu
𮀬	mrmfm
𮀍	mrmg
𮀶	mrmjq
𮁄	mrmmd
𮀔	mrmmf
𭇄	mrmn
𮁊	mrmsd
𮀶	mrmtq
𭆁	mrn
𮀴	mrnkq
𮁉	mrnlp
𮀫	mrnlr
𮁂	mrnlw
𮀌	mrno
𭼁	mrnyo
𭀽	mro
𮀺	mroge
𭤃	mrok
𮀠	mromc
𮀟	mroos
𮀮	mrord
𮁈	mrorm
𭜓	mrp
𭜦	mrp
𮀲	mrpmm
𮀢	mrqsr
𮀛	mrrd
𬻠	mrrk
𭇷	mrrp
𮀭	mrrrr
𮁘	mrsfe
𮁖	mrsjj
𮀡	mrsmf
𮀏	mrsr
𮀻	mrstr
𮀑	mrt
𮁒	mrtag
𮀤	mrtbs
𮁅	mrtco
𮁔	mrtis
𮁛	mrtjd
𮁌	mrtkt
𮁆	mrtmb
𮀥	mrtob
𮁙	mrtog
𮁚	mrtvd
𮀷	mruhj
𮁃	mrvec
𭔱	mrvi
𮁏	mrvij
𮁁	mrvmc
𭆃	mrvp
𮁓	mrwim
𮀪	mrwjo
𮀼	mrydl
𮀣	mryfk
𮀸	mrypk
𮁀	mryru
𮀨	mrytv
𭫑	msd
𭔩	msdi
𬺳	msh
𬺷	msh
𬺻	mshh
𭠅	mshke
𭠅	mshkk
𭠃	msike
𭠃	msikk
𭆊	msjl
𭠄	msjr
𮓾	mslmi
𭄆	msln
𭠀	msm
𭆱	msnhe
𭮚	msoho
𭠉	msoiu
𭠉	msomu
𭜳	msp
𭠆	mspru
𭮱	msre
𭠇	msrw
𭟿	mss
𭠂	mssr
𭠁	msyc
𭠈	msyhs
𭆍	mtaj
𮠕	mtbm
𭔰	mtdi
𭚙	mtfmu
𭚛	mthae
𮙔	mthej
𮍩	mthxu
𭟾	mti
𬻟	mtji
𬻦	mtjnk
𮙓	mtjru
𭆋	mtkr
𮙒	mtoii
𮙒	mtoml
𭆏	mtqo
𭕏	muaph
𭀩	mubhg
𮬫	muhaf
𭮨	muhne
𭮮	muhne
𭀖	mui
𮝦	mujje
𭑜	mukq
𮓸	mulmi
𭺕	mumgu
𭀞	muni
𮎁	muniq
𭭅	muno
𭞦	mup
𭀫	musmv
𮙚	muso
𭶌	musuf
𭕎	muw
𭕑	muwmv
𭀪	muypn
𭀪	muypu
𭬺	mvdo
𮗅	mvhbt
𭒍	mvhk
𭦙	mvia
𮠰	mwaa
𮠟	mwau
𮦞	mwau
𮠶	mwbbr
𮧊	mwbm
𮠹	mwbme
𭫢	mwd
𮠛	mwd
𮠢	mwdj
𮠩	mwfd
𭻴	mwff
𮠦	mwfk
𭻩	mwfm
𮠲	mwfqs
𮧑	mwgbt
𮠥	mwgr
𬻉	mwh
𮠷	mwhda
𮠱	mwhdr
𮗀	mwhey
𮠵	mwhjg
𮠝	mwhk
𮠜	mwhlo
𮗊	mwhok
𮠧	mwhon
𮗆	mwhwj
𮠠	mwihu
𭻧	mwijb
𮠳	mwikh
𮗇	mwivv
𮠫	mwjbd
𮗁	mwkii
𮡁	mwlkc
𮦰	mwll
𭻨	mwmf
𮠬	mwmmr
𮠮	mwmog
𮧉	mwmy
𮠴	mwndt
𮗃	mwnii
𮠣	mwnil
𮠨	mwnin
𮠘	mwno
𮠸	mwoae
𮖿	mwoii
𮖿	mwoml
𮠼	mwond
𮠞	mwosu
𮡇	mwpko
𮠤	mwpvo
𮧐	mwqmc
𮗌	mwsfr
𮠗	mwsm
𮡊	mwsmj
𮠪	mwsmm
𭻢	mwsmr
𮦳	mwsmv
𮧍	mwsql
𮡄	mwssp
𮡅	mwtcd
𮠻	mwtgk
𮡈	mwtgt
𮡍	mwthf
𮗋	mwtja
𮦯	mwuau
𭦫	mwva
𮗈	mwvfg
𮗉	mwvjv
𮠿	mwvmi
𭻌	mww
𮗂	mwwvj
𮠺	mwybb
𮡋	mwyed
𮡀	mwyhr
𭧆	mwyka
𭦪	mwyma
𮡌	mwyov
𮠽	mwypn
𮗄	mwysk
𮠾	mwywi
𬻁	myg
𭂳	myhn
𭭘	myls
𬻰	mymwj
𮨌	nambc
𭺨	namvn
𭯍	napp
𮯟	nauu
𮗭	nbae
𮗳	nbapv
𭎴	nbg
𮗡	nbhe
𮗢	nbhhh
𮗯	nbhhv
𮗥	nbhqu
𮗤	nbht
𮗧	nbino
𭺻	nbkd
𮗪	nblbk
𮗰	nbmmr
𮗩	nbmvn
𭺹	nbnhs
𮗦	nbno
𮩚	nboiv
𮥠	nbop
𮗬	nbpa
𮗣	nbpi
𮗶	nbrrj
𮯛	nbssu
𮗨	nbsuj
𮗴	nbtlq
𭗱	nbu
𮯞	nbusu
𮗱	nbyit
𮗲	nbyiu
𮗏	ncbuu
𭔽	ncdi
𮚰	ncncc
𮠂	ncnl
𮠉	ncnl
𭓒	ndamo
𭒽	ndbm
𭓅	ndbnd
𭏚	ndg
𮬪	ndhaf
𭒺	ndhni
𭒿	ndhqm
𭒸	ndi
𭒻	ndik
𭓍	ndjbm
𭓃	ndjru
𭓁	ndklg
𭓊	ndkmr
𭒹	ndks
𭓎	ndlsd
𭒷	ndlu
𭒶	ndmn
𭓈	ndmpm
𭓏	ndmrw
𭓛	ndnuu
𭓌	ndomb
𭓉	ndqmb
𭓄	ndqse
𭒼	ndsu
𭓐	ndtlk
𭓀	ndtmm
𭓂	ndvif
𭒾	ndwl
𭓑	ndwp
𭆥	ne
𮬔	nfanb
𮫷	nfav
𮫼	nfbms
𮬊	nfbvk
𭵫	nfdl
𮫾	nfdmf
𮬄	nfdmq
𮬀	nfhda
𮬃	nfhei
𮬐	nfhhl
𮬑	nfhoe
𮫳	nfhti
𮫿	nfhxo
𭟷	nfi
𮬇	nfihh
𮬁	nfiti
𮬎	nfkhw
𮫶	nfkki
𮫰	nfkni
𮬌	nfllp
𮬙	nfmbe
𮫵	nfmbm
𮬗	nfmht
𮬆	nfmue
𮬚	nfnmb
𮬏	nfogd
𮫽	nfomc
𮫺	nfppg
𮬖	nfqoc
𮫸	nfsj
𮫴	nfsmr
𮬉	nfthr
𮬅	nfthu
𮬍	nfthu
𮬘	nftkt
𮬍	nftqu
𮬂	nftw
𮫻	nfuau
𮬓	nfwek
𮫱	nfye
𮬒	nfypf
𮚔	ngeec
𭚬	ngr
𭿷	nhbr
𭩲	nhd
𭿸	nhdm
𭿻	nhfbc
𭿼	nhhaf
𭿺	nhihq
𭚪	nhmy
𭚧	nhne
𭚽	nhwj
𭚦	ni
𭐷	nibgr
𮗠	nibq
𭪖	nid
𭂶	nihn
𭀛	nihu
𭐸	nikoo
𭐴	nini
𭔯	ninii
𭿶	ninnh
𬻑	ninym
𮌉	niobo
𬻵	nisc
𭐵	nisk
𮘆	niymr
𭛂	njdn
𭚺	njds
𭐳	njii
𭚴	njki
𭚕	nkhqm
𭚓	nkhv
𭄶	nkks
𮫹	nkleg
𭷳	nkmhq
𭚒	nkmui
𭤇	nkmv
𭚔	nkqj
𮋊	nksmm
𮥈	nlamj
𮥍	nlapp
𮥝	nlawe
𮥧	nlaws
𮥳	nlbci
𮥒	nlbjj
𮥎	nlbui
𮥪	nldll
𭴕	nlf
𮥐	nlff
𮤻	nlfh
𮥑	nlfp
𮥂	nlgdi
𮥁	nlgr
𮭟	nlhaf
𮥉	nlhdn
𮥨	nlhdn
𮥙	nlhlv
𮥟	nlhnd
𮤹	nlhp
𮥭	nlhul
𮥕	nlibi
𮤾	nlii
𮤿	nlksr
𮥫	nlmbd
𮥡	nlmbi
𮥔	nlmca
𮥀	nlmna
𮥯	nlmrr
𮥆	nlmso
𮥊	nlnau
𮥮	nlnbe
𮥋	nlnkm
𮥋	nlnkv
𮥓	nlnom
𮥬	nlocd
𮥩	nloci
𮥢	nlogd
𮥞	nloic
𮥞	nlomc
𮥏	nlosi
𮥄	nlpa
𮤺	nlpsh
𮭏	nlqef
𮥖	nlrwu
𮤼	nlslb
𮥚	nlsmp
𭚭	nlsp
𮥛	nlstr
𮥇	nlswl
𮥣	nltgr
𮥗	nltod
𮥣	nlttr
𮥘	nluie
𮥦	nlwli
𮥥	nlwlv
𮥲	nlybk
𮥰	nlydu
𬻏	nlym
𮤽	nlyt
𮥤	nlytg
𮥅	nlyuk
𮥱	nlyxf
𭘂	nm
𮬡	nmbbb
𭚻	nmbc
𮬢	nmcim
𭼀	nmdhe
𭚶	nmfb
𮬤	nmhir
𮬣	nmhon
𮬟	nmirm
𮪢	nmit
𮪡	nmiuh
𭛅	nmlb
𭛌	nmmwm
𮬛	nmnin
𬻈	nmnlm
𭛇	nmnmb
𬻘	nmnym
𭣰	nmok
𭼄	nmomn
𭼄	nmomv
𮬜	nmpa
𭴚	nmsf
𬻆	nmsm
𮬠	nmsme
𮪤	nmtaj
𮪣	nmuce
𮬝	nmuni
𮪥	nmydk
𭅽	nnail
𭐽	nndoo
𭐶	nne
𬼹	nnf
𭶡	nnf
𬼷	nni
𭥟	nniav
𭚮	nnir
𭐾	nnkrd
𬼶	nnm
𬼻	nnmja
𮌿	nnobo
𭣡	nnok
𭐹	nnqhp
𬼼	nnqoc
𭅹	nnsu
𮫚	nntmb
𮙗	nntwt
𭑀	nnudw
𭼿	noa
𭶝	nof
𭽀	nofd
𭚳	nogb
𮨶	nogi
𭚫	nohh
𭤠	nohml
𭚸	noli
𭚹	nolu
𭽃	nomrk
𭀭	nomrp
𭽄	nomru
𭽅	nonii
𬽡	nono
𬼜	npd
𭬚	npd
𭔴	npdi
𮨞	npmbc
𮠌	npnl
𭜥	npp
𭴝	nqf
𭛆	nqoa
𮬶	nrhaf
𭃞	nrln
𭚼	nrlu
𮥌	nrmy
𭭊	nrno
𬼨	nrpd
𬼬	nrrr
𮪘	nrsqf
𮎛	nru
𬼢	nrvp
𭚷	nrwu
𭵈	nsf
𬼎	nshwe
𬼎	nshwi
𭛀	nsmg
𭚰	nsmm
𬼅	nsnhs
𭣦	nsok
𭞤	nsp
𭑩	nsv
𭚿	ntbn
𮫛	ntbn
𭛃	ntct
𭚩	ntm
𭴾	nttf
𭔷	nudi
𭅻	numsu
𭺠	numvn
𭀰	nunau
𭚱	nuyk
𮎝	nuyru
𮎝	nuyru
𮩝	nvapv
𮢳	nvc
𭔼	nvdi
𭚵	nvfh
𮩞	nvgbt
𭙉	nvi
𮩛	nvppj
𮩜	nvtk
𭦌	nwa
𭚲	nwd
𮫬	nwf
𭑏	nwk
𭐬	nwle
𭨚	nya
𭛄	nyhb
𭛉	nyto
𭛈	nywm
𬽪	oa
𭥍	oa
𬾛	oad
𬾰	oahm
𮙝	oaho
𭀠	oahu
𭧝	oamjs
𬿂	oano
𭨔	oatgr
𭨔	oattr
𮎜	oau
𮚃	obbc
𭽼	obbt
𭁧	obfh
𮌜	obgce
𮃰	obhd
𬿅	obhi
𭑟	obk
𭄜	obln
𬽽	obmr
𭀻	obn
𮗮	oboq
𭀎	obpd
𮌊	obpd
𮌕	obqme
𭇥	obr
𮯠	obta
𮙭	obuc
𭑶	obv
𮍉	obvss
𮌑	obyvo
𭔺	ocdi
𭌀	ocjrr
𬿇	ockn
𭌷	ocrrr
𬾹	ocsc
𭌛	octrr
𭫄	odd
𭫭	odike
𭫭	odikk
𬿐	odim
𭯵	odjcn
𬽭	odk
𭯴	odkb
𭃯	odln
𮨓	odmbc
𮦂	odogd
𭝱	odp
𭞝	odp
𬿭	odqn
𮘧	odymr
𬾢	oede
𬾧	oeee
𭏓	oeig
𭞠	oep
𬾣	ofbd
𭝶	ofp
𬾡	ofpd
𬾥	ofpd
𭍺	og
𮥼	ogbcr
𭬷	ogd
𭶠	ogf
𭏯	oghdv
𭀼	ogi
𬾆	ogis
𬾾	ogit
𮥸	ognhs
𭳾	ogoge
𭀂	ogrc
𭀇	ogrf
𮥺	ogso
𬾉	ogyo
𭀊	ohaf
𬾐	ohau
𬿹	ohau
𬿪	ohbk
𬾒	ohdn
𬾨	oheb
𭀉	ohef
𬽺	oheh
𬿿	ohgf
𬽰	ohjn
𬽴	ohke
𬾓	ohli
𬽳	ohnb
𬿘	ohnd
𭂯	ohnj
𬼊	ohny
𬼐	ohqj
𬾳	ohqj
𬾏	ohql
𬽬	ohs
𬿍	ohsg
𬾟	ohsl
𮅄	ohso
𬿉	oht
𬿊	ohud
𮍥	ohx
𬿆	ohye
𮖛	oiav
𮩁	oibla
𮨸	oicl
𬽼	oidm
𮩍	oidon
𮩗	oifbc
𬾖	oifm
𮩒	oigrt
𮩔	oihak
𮨨	oihni
𬽷	oii
𮨹	oiih
𮩏	oijff
𮩋	oijie
𮩍	oijon
𮨻	oijp
𮨾	oijte
𬿛	oile
𮨷	oim
𮩙	oimef
𮩎	oimhk
𮩂	oimrc
𮩖	oimtb
𮩐	oimwj
𮩓	oimwm
𬾂	oimy
𮙿	oinc
𮊀	oinw
𮩅	oiomk
𮩃	oiprf
𮩉	oirbc
𬿯	oirp
𬽬	ois
𮩌	oiseg
𬿍	oisg
𮩊	oitgk
𮩘	oitlf
𮩙	oitnf
𮩈	oitnm
𮨿	oittm
𮨼	oiuku
𮨺	oiwr
𬿚	oixp
𬾄	oiyk
𮩀	oiysk
𮩇	oiytd
𭀀	ojac
𭀄	ojhf
𬾔	ojhk
𬽶	ojhn
𬾼	ojhr
𭀁	ojim
𬿢	ojiv
𬾭	ojkr
𭘾	ojmm
𬿺	ojnf
𭅦	ojojj
𬾅	ojru
𬾽	ojwp
𬽸	ojy
𬿟	ojye
𬿝	ojyj
𭀏	okak
𮀀	okbm
𭰋	oke
𬽻	okf
𭏑	okg
𭿾	okhv
𬾝	okkb
𭄼	okks
𮀂	okmam
𮀂	okmbm
𭿽	okmn
𮀃	okmpm
𬽦	okni
𮀄	oknlr
𮀊	oknwa
𮥶	okog
𬽩	okp
𭟠	okp
𬾿	okrb
𬾦	okri
𭄞	oks
𭃜	oksh
𭞂	okshp
𭞂	oksip
𮀁	oksll
𭞂	oksop
𮀆	oktlg
𮀅	okumb
𭒘	okv
𮡖	okwg
𭀣	olai
𭝲	olfp
𬿩	olhc
𬿧	olhg
𮨨	olhni
𬾱	olhu
𬿋	oljnk
𬿔	olke
𬾂	olmy
𬿷	olnoi
𬿩	oloc
𬿧	olog
𬿃	olpd
𮭡	olpym
𬿗	oltb
𬿵	oltco
𬿾	oltd
𭀐	oltof
𬻹	olwkp
𭁕	olyc
𭣢	olye
𮡉	olyw
𬾊	oman
𬾮	oman
𬿼	ombd
𭀍	ombd
𬿲	ombe
𬿲	ombe
𭵙	ombnf
𮗟	ombq
𭵙	ombvf
𮙑	omcor
𮠖	omcw
𭴯	omdf
𬿰	omgc
𭐥	omhe
𬾈	omhl
𬾫	omin
𬾪	omis
𬽮	omjb
𬽰	omjn
𬿒	omkk
𮨆	ommbc
𬿦	ommc
𬿥	ommd
𬽣	ommn
𭁃	omncd
𭁂	omnci
𬾇	omob
𭁁	omond
𬾍	ompd
𬽬	oms
𮙿	omsc
𭵄	omsf
𬿍	omsg
𬾟	omsl
𮊀	omsw
𭀆	omtc
𭆢	omti
𬿑	omwi
𬿑	omwl
𭼂	omwo
𭁐	omxc
𬽥	omy
𭪪	ond
𭾍	onfdt
𬾩	onjm
𭯲	onmvh
𬽧	ono
𬾤	onom
𬼠	onon
𬾘	onoo
𬾲	onus
𭯳	onwkt
𭻾	onyo
𬾑	oobn
𬿸	ooci
𬽵	oodi
𭀕	oofbb
𬿈	ooge
𬿶	oogh
𭟲	ooi
𬾴	ooik
𭀉	ookf
𬿙	ookg
𬽨	ool
𭯆	oonoe
𬾀	oooo
𬾵	ooos
𬽿	oop
𬽲	oopd
𬾶	oorg
𬽾	ooym
𭝯	opdm
𮣵	opeee
𬾸	opgi
𬾠	ophp
𮣳	opki
𮣲	opm
𮣴	opnkm
𮣴	opnkv
𬿱	optf
𬾚	opuu
𮣷	opypo
𮣶	opypp
𬿣	oqbk
𮗐	oqbuu
𭙅	oqhwj
𭝺	oqkf
𬿻	oqmi
𭙂	oqpp
𭙄	oqytr
𭆹	or
𭉽	orci
𬽹	ore
𮬼	orhaf
𭯘	orhqu
𮍸	orlk
𭹖	ormg
𬽱	orms
𭈆	ormv
𬼟	orn
𮟺	orrau
𭃟	orsh
𬾋	orsn
𬿬	orso
𮪁	orsqf
𭉀	ortm
𭻉	orw
𭉁	oryck
𮖑	oryhv
𮕷	oryv
𬿤	osai
𮩁	osbla
𮨸	oscl
𮩍	osdon
𭀔	osei
𮩗	osfbc
𮩒	osgor
𮩔	oshak
𮨹	osih
𮩏	osjff
𮩋	osjie
𮩍	osjon
𮨻	osjp
𮨾	osjte
𮩆	oslsk
𮨷	osm
𬾙	osmb
𮩙	osmef
𮩎	osmhk
𮩂	osmrc
𮩖	osmtb
𮩐	osmwj
𮩓	osmwm
𭁀	oso
𮩅	osomk
𮩃	osprf
𬽯	osr
𮩉	osrbc
𮩌	osseg
𮩊	ostgk
𮩘	ostlf
𮩙	ostnf
𮩈	ostnm
𮨿	osttm
𬽢	osu
𮨼	osuku
𮨺	oswr
𭀓	oswu
𮩀	osysk
𮩇	osytd
𮠚	otbm
𭴿	otf
𭀋	otgs
𬾷	otho
𬿜	othu
𬻝	otm
𬿡	otog
𬾯	otoi
𬿀	otor
𭀒	otqr
𬿜	otqu
𬿽	otwm
𬿁	otyu
𬾎	oub
𮉲	oudhe
𮉻	oudki
𮬿	ouhaf
𭀥	oui
𬿌	ouie
𬿴	ouif
𭖯	ouk
𬿕	oumg
𮉳	oumlk
𮉸	ouokg
𭀱	ouolu
𮉴	ouoog
𮉹	ouotb
𬾌	oupp
𮉱	ouqo
𮉰	out
𮉷	outhb
𮉷	outmb
𮉵	ouyfr
𭀙	ovhu
𭀅	ovid
𮩆	ovlsk
𭀿	ovnd
𭉘	ovrr
𬿏	ovvr
𮫯	owf
𭀈	owhf
𬿓	owim
𮫮	owk
𭆶	owle
𮯝	owli
𭑒	owlk
𮊆	owlk
𮯝	owlk
𮙠	owlo
𮯝	owlo
𬿄	owlu
𭻯	owmf
𭀌	oyag
𬿮	oybk
𬿞	oycb
𬾞	oyhl
𭮬	oyhne
𮕦	oyhv
𬾬	oyic
𬾬	oyid
𬾁	oyiu
𬽫	oyj
𬾜	oyme
𬿳	oymh
𬿨	oymm
𬾕	oymr
𬿫	oyog
𬾗	oyok
𭯉	oyoyu
𬿖	oypm
𭀑	oyrm
𬾻	oyrn
𬾻	oyru
𬾃	oyvk
𭞙	pabs
𭞛	pabs
𭝑	pad
𭝿	pagi
𭦰	paijb
𭜬	paj
𭟉	panr
𭟥	pant
𭤀	paok
𭞽	pawp
𭞄	pbbe
𭝃	pbcj
𭟨	pbgn
𭝔	pbmd
𭝂	pbnd
𮠐	pbnl
𭜛	pbt
𭜜	pbu
𭜼	pbuc
𭜗	pby
𭝗	pcsp
𭝞	pdki
𮨍	pdmbc
𭅄	pe
𭴁	pf
𭿌	pfebu
𭞜	pfhf
𮂄	pfohd
𭵛	pgf
𭵼	pgf
𭝧	pgmm
𭟐	pgwc
𭍶	pgwr
𮬩	phaf
𭜿	phas
𭝰	phbp
𭐡	phhe
𭅉	phhml
𭜞	phke
𮔀	phlmi
𭞟	phnh
𭝀	phpb
𮭤	phpym
𭟊	phsu
𭭩	phymm
𭟬	phyp
𭟣	pifo
𭟍	pifp
𭜡	pii
𭜚	pipm
𮮢	pirxu
𭟊	pisu
𭜢	pit
𭅣	pjau
𭝻	pjbf
𭜲	pjbs
𭟃	pjcg
𭝄	pjcn
𮬰	pjhaf
𭟫	pjif
𭜸	pjkd
𭥘	pka
𭝷	pkaf
𭝣	pkbl
𭝎	pkmp
𬺽	pkp
𭜏	pkp
𬻎	pksr
𭝹	pkui
𭜖	plxh
𭟘	pmbb
𭟙	pmbg
𭝼	pmbp
𭜐	pmdm
𭟅	pmfi
𭏃	pmg
𭞒	pmhb
𭞥	pmhk
𭞒	pmib
𭝏	pmlb
𭞬	pmlw
𭞒	pmmb
𭞭	pmmi
𭞪	pmmp
𭜔	pmo
𭞎	pmpc
𭅋	pmrt
𭜌	pms
𭜒	pmsu
𭟊	pmsu
𭜕	pmt
𭟧	pmwb
𭞼	pmwc
𭞋	pmwp
𭟑	pmwu
𭝳	pnst
𭝭	pnup
𭟩	pogo
𭜟	pok
𭜠	pok
𭞞	pokg
𭜾	pomc
𭝕	poml
𮧒	pomwl
𭞶	porn
𭆛	ppgi
𭞿	ppoae
𭯌	ppoq
𬼙	ppp
𭯊	pprhu
𭜭	ppyk
𭟝	pqbd
𭜻	pqhl
𭟎	pqoc
𭴔	prf
𭞯	prms
𭇕	prpi
𭜴	pshh
𭝐	pshy
𭝟	psjr
𭝈	pskr
𭜤	pslp
𭝋	psmf
𭜣	psmp
𭞺	psuf
𭟒	ptaa
𭞩	ptbb
𭟈	ptbi
𭁫	ptbmm
𭞾	ptbo
𭁯	ptbq
𭞴	ptco
𭞖	ptil
𭝩	ptjr
𭝪	ptnu
𭞹	ptog
𭟇	ptor
𭅆	ptt
𭞵	ptwi
𭟭	ptwt
𭟆	ptwu
𭟤	ptwu
𭞰	ptyu
𭅊	ptyv
𭵇	puf
𮌎	pvb
𭅅	pve
𭏂	pvg
𭜱	pvok
𭟓	pwgg
𭜽	pwks
𭟗	pybk
𭟖	pybo
𭞡	pycb
𭞣	pycb
𭞻	pykb
𭞆	pykk
𭝚	pykl
𭟁	pyku
𭅈	pylb
𭞷	pyog
𭝬	pypm
𭞚	pypn
𭅇	pyr
𭝅	pytj
𭞅	pytk
𭟞	pytp
𭝽	pywr
𭾇	qabt
𭡧	qahl
𭡦	qahm
𭡰	qaiu
𭨀	qajch
𭡹	qaml
𭣉	qang
𭢶	qanx
𭡎	qapp
𭡤	qbcn
𭠾	qbg
𮧃	qbrms
𭢝	qbta
𭡐	qbtv
𭡺	qbun
𭠺	qbuu
𭽴	qcdhe
𭠡	qcr
𭉠	qcrdi
𭠓	qcsh
𮋘	qcsmm
𭡘	qcso
𮋦	qdbu
𮋪	qdbv
𮋧	qdcr
𮋤	qdcsh
𮋥	qddj
𮋨	qdjkp
𮋩	qdjnd
𭡠	qdmf
𮋣	qdnhs
𮋫	qdtts
𭠎	qe
𮮃	qee
𭡚	qegi
𭡭	qehr
𭢃	qehv
𮮇	qeihq
𮮄	qemls
𭠚	qen
𮮅	qeno
𮮆	qensu
𭣁	qfbc
𭢐	qfkq
𭢏	qfqf
𭡞	qggi
𭡉	qghv
𭡊	qgil
𭡟	qgiv
𭡳	qgou
𭢲	qgow
𭞓	qgp
𭠶	qgp
𮘱	qgymr
𭣓	qhbf
𭠪	qhbu
𭢸	qhdg
𭡽	qhdp
𭣏	qhdt
𭡻	qhhk
𭡼	qhhw
𭪛	qhid
𭡀	qhli
𭡓	qhlk
𭣊	qhmd
𭢍	qhnd
𭡗	qhor
𭡃	qhru
𭡿	qhrv
𭡙	qhsb
𮢑	qhss
𭢷	qhul
𭡗	qhyr
𭢪	qhyr
𭢋	qhyt
𭢮	qici
𭢮	qidi
𭢹	qidi
𭢹	qidi
𭡆	qifm
𭡴	qikt
𭠤	qiln
𭢫	qiod
𭢂	qiog
𭢻	qipg
𭡙	qisb
𭠵	qivi
𮈑	qivif
𮈑	qivkf
𮈑	qivof
𮖖	qiyhv
𭣇	qjco
𭡅	qjcs
𮬬	qjhaf
𭢚	qjiv
𭢇	qjjn
𭡜	qjll
𭝢	qjp
𭢼	qjpi
𭢈	qjpm
𭇈	qjr
𭠳	qjru
𭢀	qjvd
𭢙	qjwp
𭡌	qjws
𭠥	qkb
𮌳	qkb
𭠨	qkg
𭡫	qkhi
𭠮	qkke
𭠑	qkm
𭠦	qkmj
𭠗	qkr
𭡢	qkrt
𮫠	qlhui
𭉔	qlmr
𭡂	qlni
𭠒	qlxh
𭡈	qlyo
𭢛	qmbb
𭡵	qmcp
𭢰	qmei
𭠣	qmgb
𭠴	qmgt
𭢳	qmhd
𭯿	qmjn
𮀒	qmmr
𭠢	qmni
𬻥	qmnlm
𭢣	qmnu
𭰘	qmoo
𭡙	qmsb
𭠩	qmtn
𭡝	qmue
𭡲	qmue
𭢤	qmwc
𭻛	qmwl
𭍠	qmwr
𭰫	qmwr
𭍥	qmwsl
𭠏	qmy
𭡁	qnbb
𭢰	qnei
𭠖	qng
𭠬	qnir
𭠹	qnkb
𭠯	qnli
𭣐	qnmb
𭡔	qnmu
𬽤	qo
𭡪	qoae
𭁲	qoblo
𭠭	qobm
𭠜	qog
𭠕	qoj
𭢎	qolb
𭢌	qold
𭠛	qomj
𭠫	qomr
𭡾	qond
𭫘	qood
𭝌	qooip
𭝌	qoomp
𮚡	qoqoc
𭢆	qorv
𭑌	qoss
𭢨	qotb
𭡩	qoyr
𭠿	qoyt
𭡖	qoyv
𭢿	qpfe
𭎵	qpg
𬻙	qpmy
𭠷	qppg
𭠝	qpvo
𭠸	qqki
𭡡	qqmy
𭢗	qqoa
𭅏	qqpru
𭾃	qrbt
𭾄	qrbt
𭠘	qre
𭡒	qrrn
𭠻	qrsn
𮖔	qryhv
𭣃	qsca
𭢄	qshb
𭃍	qshh
𭠱	qshh
𭣄	qsiu
𭄦	qsks
𭢢	qsmp
𭠟	qsmr
𭣄	qsmu
𮧵	qsopj
𮧴	qspo
𭡇	qsql
𭡱	qstq
𭣎	qtaf
𭡶	qtaj
𭠙	qtc
𭢞	qtca
𭢘	qtcb
𭢥	qter
𭢕	qtgt
𭣍	qthj
𭢑	qthu
𭢬	qtib
𭡷	qtii
𭣅	qtlf
𭢧	qtmg
𬻡	qtmy
𭢦	qtnk
𭢑	qtqu
𭠼	quau
𭠽	qubk
𮚋	qubuc
𭡝	qune
𭠐	qvhu
𭠞	qvis
𭠰	qvlk
𭠲	qvmm
𭡯	qvmy
𭡑	qvra
𭣀	qwgg
𭡏	qwhi
𭡥	qwls
𭡨	qwpp
𭡸	qyao
𭢠	qybd
𭡬	qyck
𭢯	qycv
𭢭	qydl
𭣋	qydu
𭢁	qyfd
𭢬	qyhb
𭢊	qyhj
𭡕	qyhl
𭡮	qyjl
𭢡	qyle
𭢵	qylr
𭢬	qymb
𭢴	qymh
𭢾	qymk
𭢔	qymv
𭢟	qynv
𭢜	qyog
𭢉	qypm
𭢒	qyrj
𭢖	qyrk
𭢺	qytb
𭡄	qytj
𭢓	qytj
𭡛	qyuu
𭣌	qywv
𭈭	rab
𭌥	rabe
𭈾	rahl
𭈻	rahm
𭇽	ralb
𭌩	rana
𭊳	ranp
𮖄	rauv
𭍒	rawg
𭋎	raya
𭍈	rayv
𭉳	rbac
𭈙	rbau
𭈒	rbb
𭍑	rbbt
𭌙	rbca
𭍕	rbcf
𭊕	rbcu
𭊑	rbdh
𭍂	rbff
𮬹	rbhf
𭋐	rbhj
𭌲	rbkg
𭇖	rbmj
𭉇	rbmo
𭇒	rbt
𭊸	rbta
𭌫	rbtav
𭍔	rchwj
𭍖	rckai
𭈗	rcln
𭉃	rcmt
𭊒	rcro
𭍊	rcue
𭊦	rddf
𭊃	rddn
𭊄	rdlk
𭋶	rdlv
𭇶	rdnd
𭊂	rdwg
𭈴	rdyg
𭋞	rdys
𭯶	re
𭉴	reag
𭉴	ream
𭈡	rebm
𭇙	ree
𮒒	rehf
𭉴	rehg
𭉴	rehm
𭈠	reho
𭉉	rehr
𭈣	rejd
𭇮	rem
𮨄	rembc
𮨐	rembc
𭇲	reno
𭇳	reno
𭉼	reog
𭌼	reow
𭣈	req
𭈟	reqp
𭋫	retk
𭒂	rev
𭒕	rev
𭍀	rfbf
𭋌	rfbm
𭉧	rfbu
𭌨	rfrhq
𭚜	rft
𭍗	rftaw
𭈷	rgav
𭋄	rgbo
𭌍	rgcc
𭊥	rgce
𭉞	rgcl
𭌏	rgem
𭋱	rgfd
𭉚	rgik
𭋣	rgkf
𭌤	rgki
𭈲	rgmm
𭋴	rgrc
𭈯	rgyvo
𭋔	rhaj
𭈛	rhdd
𭉬	rhdd
𭋓	rhde
𭌶	rhde
𭈀	rhdi
𭈜	rhew
𭋒	rhfl
𭇆	rhg
𭊔	rhie
𭊔	rhik
𭇩	rhlm
𭋖	rhlw
𭇨	rhmf
𭇓	rhmy
𭊵	rhnf
𭊗	rhnh
𭊓	rhnq
𭈕	rhog
𭊷	rhol
𭉂	rhov
𭆿	rhp
𭈘	rhqh
𭉪	rhqi
𭺲	rhqm
𭋑	rhqq
𭈅	rhru
𭈞	rhsb
𭉮	rhsm
𭊴	rhup
𭇇	rhvp
𭍉	rhxf
𭌬	rhyb
𭍌	rhyp
𭉄	rhyu
𭌺	ria
𭍓	ridai
𭌹	rifb
𭋙	rife
𭉸	rifi
𭈢	rifl
𭈉	rifm
𭉷	rifm
𭉸	rifm
𭉌	rifp
𭊙	riho
𭇗	rii
𭋁	riip
𭊚	rijo
𭇀	rik
𭈧	rikm
𭇫	rill
𭉍	rilv
𭉕	rimi
𭉶	rimk
𭇘	rinn
𮕊	rinoi
𭊺	rinq
𭌃	riop
𭉊	rior
𭌓	rir
𬻼	rirv
𭈞	risb
𭉮	rism
𭊛	rixp
𭌎	rjau
𭈍	rjav
𭋉	rjby
𭉾	rjii
𭋲	rjim
𭋳	rjjb
𭌋	rjjn
𭌋	rjjv
𭇬	rjnd
𭇞	rjpn
𭋂	rjqmc
𭋷	rjrsj
𭋝	rjsk
𭊻	rjty
𭦖	rka
𭇡	rkdi
𭈗	rkdn
𭽞	rkha
𭉭	rkhg
𮔧	rklmi
𭇃	rkm
𭆸	rkn
𭊨	rkrm
𮡝	rkrwg
𭈽	rlid
𭊍	rllp
𭀾	rlo
𭈥	rlsb
𮋽	rlsj
𮛤	rmaa
𮛥	rmab
𮛴	rmabt
𮛲	rmahm
𮜎	rmbdh
𭊤	rmbi
𭉿	rmbn
𮛷	rmbon
𮛪	rmbqo
𭍆	rmbr
𮛩	rmbyr
𭉟	rmca
𮛌	rmci
𮜄	rmckn
𭊇	rmcw
𭈫	rmem
𭌹	rmfb
𮛦	rmfbd
𮜛	rmfcc
𭋙	rmfe
𭉸	rmfi
𭈢	rmfl
𭉷	rmfm
𭉸	rmfm
𭉌	rmfp
𮛗	rmfsm
𮛄	rmg
𭋰	rmgb
𮜜	rmgcc
𮜡	rmgkf
𭋡	rmgn
𮛝	rmhdn
𮛺	rmhjg
𮛸	rmhju
𮛧	rmhlo
𮜏	rmhnd
𭧹	rmhoa
𮛼	rmhoa
𮜀	rmhoo
𮛨	rmhpa
𮛛	rmhru
𭧹	rmhya
𮛼	rmhya
𮜦	rmifm
𮜒	rmiih
𮜇	rmijj
𮜑	rmilb
𮛭	rmilo
𮛕	rmine
𮜥	rmiyf
𭆺	rmj
𮛱	rmjds
𮛯	rmjir
𮜞	rmjmc
𮛬	rmjmr
𮛡	rmjtu
𭈿	rmke
𮛹	rmkhi
𮛏	rmkm
𮛢	rmkmf
𮛂	rmkn
𮛰	rmknn
𮜆	rmkok
𮜗	rmkrc
𮛮	rmkri
𮜊	rmkwi
𮛆	rmlb
𮜩	rmmbg
𭌔	rmmjk
𭆻	rmmm
𮛉	rmmmr
𮜁	rmmrb
𮛊	rmmsu
𮛃	rmmy
𮛐	rmmym
𮛁	rmn
𭉝	rmnd
𮛫	rmnhx
𮜓	rmnii
𮛒	rmniy
𭌔	rmnjk
𮛈	rmnl
𭊧	rmnn
𭇟	rmnp
𭇎	rmnr
𮜅	rmobc
𮜚	rmoci
𮛜	rmoir
𭇹	rmoo
𮜉	rmooo
𮜕	rmooo
𭉊	rmor
𮛞	rmpdk
𮛻	rmpib
𮛚	rmppg
𮛋	rmq
𮜢	rmqai
𮜡	rmqkf
𮛠	rmqrs
𭈞	rmsb
𮜠	rmsca
𭉮	rmsm
𮛟	rmsme
𮜃	rmsqf
𮜨	rmtbf
𮜙	rmtcd
𮜖	rmtgr
𮜝	rmtgt
𮛔	rmtmm
𮜌	rmtod
𮜂	rmttb
𮜖	rmttr
𮜤	rmtwm
𮛙	rmtyo
𮜧	rmurj
𮜘	rmvfr
𮜬	rmvik
𭋟	rmwe
𭊩	rmwg
𮛘	rmwk
𮛳	rmwki
𮛵	rmwlb
𮜍	rmwlm
𭋢	rmwm
𮜔	rmwmi
𮛴	rmwot
𭆼	rmy
𮛶	rmybc
𮜪	rmydu
𮛓	rmyk
𮛑	rmymy
𮛽	rmyrn
𮛽	rmyru
𮛾	rmyta
𮜐	rmyub
𮛇	rmyv
𭇂	rn
𭈦	rndo
𭈫	rnem
𭉹	rnhi
𭊞	rnks
𭈪	rnlp
𭉓	rnlq
𭌇	rnlq
𭉑	rnlv
𭌡	rnmm
𭊶	rnnn
𭈔	rnom
𭈂	roam
𭈄	rodm
𭉨	rogs
𭌭	rohc
𮛎	roimo
𭈓	rojk
𭇿	rokr
𭉫	rolh
𭈁	roll
𭊏	romb
𭌞	romb
𭋨	rome
𭈚	romm
𭌁	romm
𬻚	romn
𭈖	romn
𭌝	rooi
𭌝	rook
𭌝	rook
𭋿	room
𭇧	rop
𭌜	ropo
𭇺	ror
𭍍	rork
𭌸	rorq
𭋩	rotq
𭇔	rou
𭋕	royg
𭉩	royr
𭇣	rpa
𭉆	rpav
𭌒	rpdc
𭌑	rpfc
𭋹	rpfd
𭋺	rpfe
𭉱	rpjd
𭋪	rpji
𭋅	rpkd
𭋤	rpkd
𭋸	rpkd
𭉰	rpmr
𭇉	rpo
𭍃	rpom
𮊼	rpsmm
𭤙	rpyk
𭉛	rqag
𭉛	rqam
𭊪	rqav
𭌰	rqhu
𭉛	rqhxg
𭉛	rqhxm
𭊁	rqkf
𭋣	rqkf
𭈵	rqvn
𭉜	rqwg
𭈼	rraj
𮗔	rrbuu
𭩸	rrd
𭑍	rrk
𭌪	rrmbr
𮨘	rrmcr
𭊱	rrme
𭈑	rrmnr
𭋧	rrnlc
𭍙	rrnli
𭊎	rrnlr
𭬫	rrocd
𭇾	rroin
𮟹	rrrau
𭊯	rrrs
𭋾	rrsjr
𭊉	rrsmr
𭊲	rrvll
𭊀	rryhv
𭤝	rryjr
𭌣	rsem
𭌱	rser
𭍇	rsff
𭈋	rsha
𭌆	rshe
𭈹	rshqb
𭈩	rsie
𭈶	rsijb
𭈩	rsik
𭇰	rsim
𭍅	rsjr
𭈳	rsju
𭈨	rsln
𭈌	rslo
𭋃	rslp
𭈌	rsly
𮬋	rsnwf
𭋍	rsomb
𬻷	rssio
𭌻	rsxf
𭋽	rtae
𭌾	rtag
𭋼	rtap
𭊫	rtcb
𭌖	rtdd
𭌵	rtgi
𭌟	rtgs
𭌧	rthf
𭊊	rthj
𭈎	rthk
𭋦	rtja
𭌢	rtjj
𭊋	rtjm
𭉈	rtjp
𭉋	rtkk
𭊭	rtku
𭃬	rtln
𭇐	rtm
𭇻	rtmd
𭋇	rtmk
𭊮	rtmo
𭉡	rtog
𭉙	rtor
𭈺	rtph
𭈏	rtqo
𭌅	rtqv
𭇼	rtru
𭇴	rtt
𭋥	rtwn
𭌕	rtyg
𭩿	rud
𭆯	ruhe
𮮣	rupa
𭌴	ruqii
𮋗	rusmm
𭚝	rut
𭑭	ruv
𭩿	rvd
𭌽	rvdc
𭊜	rvdl
𭋯	rvdo
𭉏	rvep
𭶃	rvf
𭋀	rvfb
𭋮	rvfb
𭍋	rvfc
𭊠	rvfd
𭊾	rvfg
𭌯	rvfi
𭊿	rvfm
𭊽	rvfr
𭍘	rvfu
𭌈	rvfw
𭉻	rviv
𭌮	rvmb
𭉐	rvmg
𭊟	rvmi
𭉗	rvmr
𭝫	rvp
𭉺	rvsl
𭈊	rvvu
𭌘	rwfn
𭋏	rwlm
𭃒	rwln
𭋏	rwlv
𭋊	rwlw
𭋈	rwly
𭻦	rwpp
𭋋	rwrc
𭊈	rwtc
𭋗	rybj
𭇊	ryc
𭉎	rycn
𭌗	rycn
𭍄	rydj
𭇅	rye
𭋻	ryfd
𭌚	ryfe
𭋜	rygv
𭊹	ryio
𭈇	rykb
𭉲	rykk
𭇯	rykn
𭉯	ryko
𭆽	rym
𭈮	rymf
𭉤	rymi
𭌗	rymn
𭈤	ryno
𭊰	rypf
𭌦	rypf
𭍎	rypj
𭈐	rypm
𭊌	rypm
𭋭	ryrb
𭌄	ryrb
𭍏	ryrc
𭊘	ryrl
𭌂	ryrx
𭋬	rytb
𭌿	ryui
𭌿	ryul
𭍐	ryuo
𭇭	ryvv
𭈈	ryw
𭉣	rywg
𭅝	safv
𭕶	saibi
𭕔	sb
𭕤	sbcn
𭯩	sbhqu
𭺸	sbq
𭕘	sbu
𭕼	sbui
𭔪	scdi
𮝿	scmmv
𮠂	scnl
𭟏	scp
𭮺	scre
𭕸	sddr
𭕕	sdm
𭭏	sdno
𭿐	sebu
𮢶	sec
𭰇	see
𭴸	sef
𭕝	sej
𮕉	selmi
𮡆	semcw
𭕵	semg
𭆳	semmi
𮡠	semwg
𭅛	seoi
𭅛	seol
𭞊	sep
𭆰	sepd
𮋺	sesj
𮋅	sesmm
𮩤	sethu
𭒒	sevv
𮖎	seyhv
𮩾	sfee
𭵢	sff
𮪋	sfff
𮪆	sfhds
𮪅	sfije
𮪠	sfjcv
𮪃	sfjnd
𮪈	sfjtu
𮪐	sfkcq
𮪎	sfkiw
𮩳	sfkni
𮪞	sfkrd
𮪖	sfktc
𮩽	sflln
𮩿	sflmi
𮪝	sfmmi
𮩺	sfmob
𮪜	sfmtp
𮩷	sfmvu
𮪕	sfmwd
𮪀	sfnau
𮩶	sfno
𮩹	sfno
𮪟	sfomb
𮪗	sforr
𮪓	sfort
𮩲	sfp
𭊢	sfrp
𮪚	sfrrd
𮪊	sfsje
𮪙	sfsmh
𮪄	sfsmm
𮪉	sfsmv
𮪇	sfsss
𮪏	sftlj
𮪒	sftlk
𮪑	sftmo
𮪔	sfune
𮩼	sfve
𮪌	sfvvw
𮪍	sfytr
𮪛	sfyvn
𭯪	sghqu
𭣟	sgje
𭕚	sgpd
𮛿	sgryo
𭃽	shahu
𮫐	shand
𭃫	shapp
𭃋	shau
𮚰	shbcc
𭕜	shbr
𮚕	shbuc
𭃈	shcms
𭃦	shcnh
𭃇	shei
𮫋	shfhn
𮫍	shggi
𭃕	shgr
𭃙	shhbu
𮫑	shhde
𮪽	shhk
𭷔	shhq
𮫃	shjkp
𭕠	shjm
𮫂	shjmn
𭃛	shkd
𭃼	shkrd
𮫊	shlmy
𮫓	shmbg
𮫁	shmr
𮫎	shmue
𮫇	shmui
𮫎	shmuk
𮫄	shnsd
𭃘	shobo
𭕞	shoe
𭃝	shoi
𭃮	shoip
𭕫	shoo
𭃃	shp
𮪾	shp
𭕪	shrb
𭇌	shrp
𭄎	shsja
𮫌	shsmb
𭄝	shtgo
𭕩	shui
𮫅	shvif
𮫈	shvyv
𮫉	shwls
𮫏	shwlv
𭃠	shyck
𮪿	shyj
𭃉	shyk
𭃢	shyk
𭃑	shymy
𮣽	siciu
𭲐	sie
𮣸	siei
𮫀	sihhr
𮫆	sihhu
𮣺	siik
𭕖	sike
𮣹	sike
𮣼	sikms
𮓵	silmi
𮤁	silmy
𭃅	siln
𮤃	simwf
𮣾	sinbg
𮣾	sinbq
𮣿	siogb
𭕡	sioq
𮤅	sitav
𮤀	sitys
𮤆	siuce
𮤄	siwvf
𮤂	siybs
𭃷	siymm
𮋴	sjbun
𭽺	sjdhe
𮋳	sjdoo
𮋿	sjgwc
𮭚	sjhaf
𮋰	sjice
𮋬	sjik
𮋲	sjjmu
𮋷	sjkhi
𮋮	sjki
𮋭	sjpd
𮋱	sjphr
𮋶	sjptd
𮋼	sjseo
𮌀	sjsjj
𮋯	sjsp
𭃎	sjtt
𮋸	sjyij
𮋵	sjytv
𮚚	skbuc
𮓵	sklmi
𭃅	skln
𮡟	skmwg
𭃷	skymm
𮍓	slasm
𭆗	slmad
𭕛	slmi
𭉒	slmnr
𮍑	slokr
𭝤	slp
𭌉	slrai
𭘍	slsu
𭕯	sluq
𬼖	sm
𭛒	smbjj
𭅕	smd
𭵧	smf
𭝊	smfp
𭛍	smhhl
𭯥	smhqu
𭅙	smig
𮊽	smihs
𭅖	smj
𭅞	smjk
𮋌	smjmm
𭘒	smlb
𭻋	smlwh
𮋕	smlx
𬺴	smm
𬺹	smm
𮋎	smmrb
𮊻	smok
𮋁	smomr
𭕡	smoq
𭜎	smp
𭮭	smre
𭃊	smsmm
𭜵	smsmp
𭛎	smsp
𮊾	smtc
𭕥	smue
𮋓	smvit
𮋂	smyck
𭛐	smyoj
𭅚	snin
𭅞	snjk
𭿵	snnh
𭥜	soa
𭕢	soglc
𮓵	solmi
𭃅	soln
𭃷	soymm
𭅔	sp
𭶵	spbme
𭕱	spbvk
𮠇	spnl
𮥻	spog
𭕗	sppd
𭃂	sq
𭕷	sqhb
𭕭	sqlb
𭕣	sqpr
𭕙	sqq
𮩵	sqsb
𬼋	sqsk
𮩸	sqsl
𮩴	sqst
𮕹	sqsv
𭁝	sqtc
𭾑	srbt
𭇱	srcsh
𭵳	srf
𭝝	srgp
𭊝	srhkr
𭕮	srjkp
𮦻	srmbg
𭊝	srmkr
𭕴	sroii
𭣶	srok
𭕴	sroml
𭕻	sromo
𭞏	srp
𭕽	srqoo
𭕹	srqor
𭬌	srxu
𮝻	srytq
𮊸	ssa
𭩢	ssd
𭽪	ssdhe
𭘈	ssoin
𭘈	ssomn
𮋀	ssono
𮊿	ssop
𭕰	stmb
𭅜	stmo
𭕺	sufba
𭕨	suher
𭅲	sui
𭯢	suiav
𭯫	sulvk
𮟿	sunl
𭝨	sup
𭕟	supd
𭔲	supdi
𭉖	surp
𭕳	sushx
𮠎	susjl
𭕧	suyhv
𭅗	sw
𭅘	syg
𭕬	sykq
𭯜	tahqu
𭣚	taike
𭨂	tajbc
𮐋	taki
𮒼	tana
𭨂	tapbc
𮒮	tasc
𮎣	tau
𮏃	tav
𮎟	tb
𮐐	tbav
𮓑	tbbj
𮒆	tbbk
𭇒	tbbm
𭿃	tbbu
𮗛	tbbuu
𮐧	tbcp
𭽬	tbdhe
𮎭	tbe
𮒱	tbha
𮐱	tbhe
𮑈	tbhe
𮑎	tbhj
𭸪	tbik
𭔿	tbmdi
𮑬	tbme
𮒿	tbof
𮐨	tbov
𮐔	tbpk
𮑚	tbqp
𭬟	tbssd
𮏰	tbup
𮐊	tbup
𮑥	tbuv
𮒰	tbvg
𭣹	tbye
𮓩	tccms
𭰭	tce
𮑍	tcfh
𮫡	tchui
𮨽	tciav
𮏉	tcie
𭄭	tcks
𭁚	tclpb
𭛁	tcnok
𮓈	tcoe
𮏏	tcog
𭜝	tcp
𭅌	tcpi
𮭥	tcpym
𭁞	tctav
𮈍	tcvif
𮐿	tdbb
𮓇	tdbbe
𮒩	tdem
𭛙	tdhhh
𮐡	tdib
𮓎	tdlga
𮑾	tdll
𮒬	tdnb
𮒙	tdow
𮐆	tdrsn
𮒞	tdwf
𮏍	teau
𮪷	tebbb
𮑵	tebe
𮑔	tedw
𭵠	tef
𮏿	tehd
𮏟	tehe
𮑓	tehe
𮒌	teih
𮑰	tejc
𮒐	temu
𮑮	teoe
𮏠	teop
𮑲	tete
𭹬	teug
𮒎	teuk
𮎷	tevm
𮏝	teyr
𮚏	tfbc
𮮠	tfbf
𮑇	tfbk
𮓊	tfgc
𮎦	tfk
𮒥	tfkk
𮜣	tfko
𮨤	tfmbc
𮐚	tfmo
𮑴	tfnk
𮊲	tftq
𮗚	tgbuu
𭔸	tgdi
𭔹	tgdi
𭔾	tgdi
𭊬	tgdp
𮌭	tgfb
𮊰	tgfio
𮊰	tgfmo
𮊱	tgftq
𮐦	tggi
𮊫	tghdp
𮊢	tghe
𭇵	tghl
𭶢	tgif
𮒛	tgii
𮒸	tgiv
𭶢	tgkf
𮒛	tgki
𭄿	tgks
𮒸	tgkv
𭄈	tgln
𮠆	tgnl
𭭕	tgno
𮦃	tgog
𮒫	tgqf
𮏦	thad
𮎲	thau
𮒾	thcq
𮑭	thda
𮑨	thdb
𮑧	thdd
𮏷	thde
𮒗	thde
𮑼	thdi
𮒋	thdi
𮑉	thdj
𮒤	thdj
𮐠	thdu
𮑏	thdu
𮐬	theb
𮎬	thhv
𭟱	thi
𭶧	thjf
𮒘	thkr
𮓀	thni
𮐒	thoe
𭅐	thp
𮏚	thpa
𮏡	thpd
𭉵	thppr
𮍹	thppr
𮐳	thqb
𭽶	thrje
𭘊	thru
𮑩	thuu
𮎤	tib
𮐝	tibp
𮑑	tifb
𮒓	tifb
𮐁	tifo
𮑖	tifu
𮎶	tihj
𮐺	tiht
𮑙	tiif
𮑛	tiiu
𮒘	tikr
𮐻	timr
𮐼	tims
𮓅	timwl
𮐘	tioj
𮑷	tipr
𮧠	tjahl
𮑤	tjalb
𮐖	tjbc
𮑐	tjbc
𮏋	tjce
𮐙	tjcu
𮓆	tjcwa
𭩠	tjd
𮒻	tjeg
𮒂	tjem
𮒩	tjem
𮐗	tjfu
𮧦	tjgrr
𮎸	tjhj
𮧔	tjhk
𮧕	tjhqo
𮧣	tjhye
𮏎	tji
𮐅	tjid
𮑀	tjii
𮧢	tjirp
𮐈	tjis
𮒜	tjjb
𮒚	tjkf
𭃱	tjki
𭃱	tjkk
𭃱	tjko
𭅒	tjkp
𮎫	tjlk
𭄚	tjln
𮧛	tjlst
𮐌	tjmdm
𮏧	tjmg
𮧘	tjmhn
𮐃	tjmo
𮐍	tjmvh
𮏱	tjmy
𮐵	tjni
𮏑	tjnu
𮧖	tjodi
𮧟	tjokb
𮒇	tjomb
𮧭	tjomf
𮧨	tjonq
𮧫	tjotb
𮒙	tjow
𮧞	tjqmb
𮧪	tjrrs
𮧥	tjstv
𮧬	tjtbh
𮧧	tjtlm
𮒠	tjtmr
𮏔	tjtu
𮑅	tjtw
𮧚	tjwls
𮏳	tjwo
𮧜	tjyit
𮧡	tjyta
𮧝	tjytj
𮧩	tjyub
𮧙	tjyvo
𮣂	tkc
𭶍	tkf
𮊮	tkfmu
𮐫	tkha
𮐑	tkhb
𮐴	tkhg
𮏺	tkhi
𮏶	tkhk
𭅟	tkhlu
𮏛	tkhr
𮏜	tkhu
𮑂	tkja
𭑢	tkjk
𭘷	tklb
𮎴	tkna
𮏯	tkon
𭟂	tkp
𭀤	tkpc
𭋆	tkr
𮍅	tkrb
𮉔	tkrf
𮎨	tkru
𮐟	tksd
𮏒	tlb
𮎧	tlbc
𮑱	tlib
𮊨	tljk
𭃻	tlln
𮎮	tlmo
𮐎	tlmu
𮒢	tlvo
𮎩	tma
𮓕	tmbb
𮓓	tmbe
𮑿	tmbi
𭺺	tmbq
𭺭	tmbtq
𮒃	tmdm
𮐹	tmef
𮑑	tmfb
𮒓	tmfb
𮐁	tmfo
𮑖	tmfu
𮐢	tmgb
𮑃	tmgd
𮐥	tmgn
𭐢	tmhe
𮏬	tmhw
𮎾	tmik
𮒘	tmkr
𭄳	tmks
𭭡	tmmm
𮏓	tmmm
𭐅	tmnau
𮏭	tmnm
𮑽	tmov
𭺬	tmpa
𮐾	tmpt
𮏁	tmrp
𭄀	tmshi
𭄀	tmsk
𭄀	tmso
𮏂	tmth
𮒪	tmtj
𮑡	tmto
𮐇	tmwr
𮑄	tmwr
𭺯	tmycn
𮏴	tnbs
𮏢	tndm
𮐹	tnef
𮓖	tnfm
𮒷	tnjd
𮒵	tnjv
𮐷	tnlh
𭃾	tnln
𮐶	tnlp
𮒧	tnlq
𮓌	tnmd
𮏘	tnmu
𮓃	tnmv
𮏅	tnof
𭣵	tnok
𮒉	tnuu
𮐲	toah
𮏈	toam
𭾂	tobt
𮏽	tode
𮐮	tode
𮒣	togb
𮏸	tohi
𮐏	tohq
𮎱	tohv
𮑊	tokn
𭀃	tolk
𮎥	tom
𮒯	tomb
𮏊	tomc
𮎡	tomn
𮑫	toqc
𮐯	torb
𮏼	toye
𮒊	toyg
𮏻	toyk
𮏵	toyr
𭜑	tp
𮪶	tpbbb
𮐜	tphh
𮐰	tphu
𮑺	tpii
𮎯	tpoo
𮎠	tpp
𭞱	tppd
𮐰	tppn
𮒦	tpps
𮏐	tptc
𮍋	tpwb
𮏹	tpyr
𮊳	tqhuj
𮊥	tqih
𮊭	tqihi
𮊭	tqihm
𮐉	tqik
𮏀	tqme
𮊴	tqmwu
𮐄	tqng
𭭋	tqno
𮊣	tqno
𮎪	tqoc
𮒟	tqoc
𮒝	tqof
𮊬	tqomb
𮊧	tqpmm
𮒁	tqsr
𮒹	tqyr
𮏫	trcms
𮑟	trcnh
𭵌	trf
𭎙	trg
𮎹	trg
𭌠	trgyo
𭟽	tri
𮐪	trid
𮒀	trihr
𮧓	trj
𮏆	trkn
𮏲	trli
𭃵	trln
𮎺	trmg
𮒄	trml
𮐤	trmnr
𮐽	troir
𮐽	tromr
𮒏	tros
𮓄	troyb
𭞍	trp
𭋘	trtpr
𮓍	tsdv
𮣡	tsec
𭏶	tsg
𮇽	tsid
𮒶	tsjd
𮓒	tsjd
𮓂	tsjq
𭒯	tsjv
𮎻	tsku
𮫙	tslb
𮑠	tslj
𮎼	tsll
𭃪	tsln
𮇽	tsmd
𮑹	tsme
𮐂	tsmg
𮏕	tsrb
𮏨	tsrb
𮑞	tsrg
𮓔	tswu
𬻀	tt
𭾓	ttapv
𮑢	ttbg
𭘧	ttblb
𮑣	ttce
𮑁	ttco
𮏮	ttcu
𭙇	ttcwa
𮑶	ttef
𮏖	ttgo
𮙕	tthhh
𭯱	tthvi
𭯱	tthvm
𬻋	tti
𭪙	ttjd
𮏩	ttjd
𮒺	ttjr
𮏣	ttmv
𬾺	ttoii
𬾺	ttoml
𬼩	ttpd
𭘺	ttsmb
𮩥	tuahm
𮑪	tuce
𭐱	tuhe
𮊦	tui
𮐭	tuie
𮩢	tuije
𮩟	tujk
𮏇	tuku
𮓉	tuotf
𮩡	tupa
𮩣	tuuje
𮩠	tuyk
𮑘	tvbe
𭔶	tvdi
𮒖	tvfa
𮒨	tvfa
𮒔	tvfb
𮒴	tvfi
𮓁	tvfi
𮑝	tvfj
𮐸	tvfn
𮑗	tvfr
𮒕	tvfv
𮖢	tvgv
𭺶	tvhqm
𭅧	tvht
𭵝	tvif
𭁄	tvj
𮎢	tvle
𮌅	tvlq
𮎿	tvmk
𭺧	tvmvn
𮑻	tvmw
𮎰	tvou
𮎽	tvsl
𮐞	tvvu
𮎵	tvyg
𮏥	twa
𭈰	twbw
𮒈	twce
𮏄	twd
𮓐	twfr
𭨜	twi
𮡂	twihr
𮡃	twikm
𭁔	twlc
𭬽	twld
𮑦	twld
𮒭	twlg
𭁗	twlk
𮓏	twlm
𭃗	twln
𮒽	twlr
𮒡	twmf
𭨙	twmms
𭆒	twmrv
𮎳	twms
𮐩	twog
𭨛	twoin
𮉶	twoju
𭨛	twomn
𮏗	twph
𮏤	twrg
𮑆	twtr
𮐀	tycv
𮏙	tyhg
𮐕	tyhr
𮑌	tyhv
𮑒	tyid
𮏌	tyik
𮓋	tyjj
𮑋	tyly
𮐣	typo
𮐣	typy
𮬕	tyrf
𮒲	tyrh
𮒑	tyro
𮑳	tyrq
𮏾	tysf
𭣺	tysk
𮑸	tysm
𮒳	tysw
𮑕	tytl
𮒍	tytv
𮏪	tyva
𮐛	tyvb
𮏞	tyvu
𮑜	tywf
𭖬	uaht
𭖌	uam
𭗮	uami
𭖣	ubcr
𭽵	ubdhe
𭗂	ubfmu
𭗛	ubhf
𮋟	ubhke
𭖍	ubm
𭗄	ubve
𭖦	ucor
𭗣	udec
𭗁	udmm
𭗔	udog
𮮩	uegte
𭆫	ueke
𭖧	uemg
𮫖	uesv
𭖛	ueu
𭗋	ufhg
𭖶	ufhu
𮨙	ufmbc
𭖙	ufmu
𮨋	ugmbc
𮙘	ugmrt
𭗇	ugni
𭖠	ugpm
𭗖	ugrr
𭖩	ugtj
𭖸	uhak
𭗃	uhau
𭗪	uhdi
𭖥	uhel
𭖼	uhjg
𭂻	uhju
𭖹	uhju
𭗒	uhok
𭗓	uhok
𭗯	uhon
𭖤	uhqb
𭺱	uhqm
𭗌	uhrm
𭖻	uhsl
𭪼	uhwd
𭖨	uice
𭗉	uihs
𭖢	uijb
𭗰	uimo
𮠀	uinl
𬼫	uiuii
𭗞	uiwb
𭗧	ujbhx
𭗸	ujcc
𭖗	ujes
𭗨	ujim
𭗠	ujjj
𭗈	ujpu
𭗏	ujpu
𭖡	ujru
𭗸	ujuc
𭗢	ukhk
𭑄	ukk
𭖘	uklg
𭂿	ukmcp
𮀘	ukmr
𭭍	ukno
𭖉	ulbu
𭖈	ulll
𭖎	ulll
𭖎	ulln
𭖖	uma
𭖂	umd
𭖅	umi
𭗐	umjk
𭩱	ummd
𭗕	umme
𭖁	ummm
𮙚	umso
𭖆	umsu
𭖋	umvn
𭖄	umy
𭗅	undf
𭂲	unhn
𭐼	unhwj
𭖚	unin
𭗐	unjk
𭗴	unkq
𭖰	unlp
𭖀	uno
𭖃	uno
𮭦	unpym
𭖷	unsp
𭗹	unuu
𭖏	uog
𭗚	uoii
𭖺	uomm
𭗙	uomu
𮠓	uonl
𬼘	up
𭖑	uph
𭖿	upmm
𬼚	upp
𭗀	uqlr
𭖒	uqm
𭖪	uqmy
𭗦	uqyd
𭖫	urmr
𭇝	urp
𭗭	urrk
𮬵	ushaf
𭗫	ushe
𭖻	usil
𭗵	usjj
𭖱	usjr
𭗑	usmb
𭖕	usmg
𭗗	utbf
𭗘	utco
𭗆	utct
𭖾	utgp
𭗡	utgt
𭗶	utis
𭖓	utj
𭗬	utlf
𭖳	utmo
𭺤	utmvn
𭖾	utqp
𭗳	utsj
𭂲	uuhn
𮐓	uuhoo
𭗷	uujk
𮂬	uukb
𭂽	uukd
𭃀	uumcp
𭃁	uummp
𮧋	uumwl
𭣩	uuok
𮋚	uusmg
𭗜	uvfu
𭖞	uvii
𭖝	uvnd
𭂼	uvvv
𭖴	uwls
𭖵	uwpp
𭖭	uyaj
𭖒	uyg
𭖮	uyhm
𭖮	uyhv
𭖟	uyk
𭗊	uyko
𭖐	uylb
𭖇	uylm
𭗩	uyms
𭗥	uymu
𭗝	uyog
𭗲	uyti
𭗍	uytj
𭑷	vaj
𭒴	vayv
𭬏	vbd
𭟶	vbip
𭑳	vbr
𭑰	vbu
𭒈	vbuh
𭒄	vcsp
𭛘	vdhhh
𭒊	vdjv
𮇊	vdmy
𭁮	vdob
𮕡	vehbt
𭷘	vehq
𮂃	vekmf
𮛖	veryo
𭴇	vf
𮈎	vfaj
𮈬	vfamh
𮉚	vfanw
𮉆	vfble
𮈉	vfbq
𮉛	vfbug
𮉜	vfbwi
𮣩	vfc
𮈼	vffbb
𮈲	vffbc
𮈰	vffbd
𮉇	vffbr
𮈿	vffqu
𮈭	vfhhj
𮈯	vfhlp
𮉌	vfhnm
𮉌	vfhnv
𭯮	vfhqu
𮈔	vfhvf
𮈶	vfhyv
𮈐	vfike
𮈞	vfimm
𮉁	vfjbd
𮈠	vfjcn
𮈾	vfjcp
𮈌	vfjkk
𮈽	vfjkr
𮈶	vfjnm
𮉒	vfjpi
𮈒	vfjru
𮈦	vfjte
𮈇	vfkm
𮈆	vfkr
𮈡	vfle
𮉂	vflgm
𮈨	vflmb
𮉟	vfmbp
𮈈	vfmfj
𮈥	vfmfm
𮉗	vfmht
𮈤	vfmmk
𮉐	vfmwf
𭓝	vfndd
𮈢	vfnif
𮎂	vfniq
𮉍	vfnjc
𮈂	vfnl
𮈮	vfnsp
𮉖	vfogb
𮈳	vfoge
𮈄	vfok
𮈚	vfokr
𮉎	vfolf
𮈜	vfpfd
𮈊	vfph
𮈅	vfpk
𮉄	vfqhf
𮉋	vfrij
𮉋	vfrji
𮈻	vfrjw
𮈩	vfrli
𮜭	vfryo
𮈧	vfsav
𮈙	vftbn
𮉊	vftsa
𮉈	vftso
𮈃	vftt
𮈝	vfttc
𮈕	vftyo
𮈁	vfu
𮈟	vfufd
𮈪	vfumb
𮉃	vfvit
𮈸	vfvvc
𮉑	vfwdv
𮈗	vfwjr
𮈣	vfwlm
𮈫	vfwls
𮈘	vfwlv
𮈱	vfyan
𮉞	vfybg
𮉀	vfycb
𮉏	vfydq
𮈵	vfyfd
𮈷	vfyfr
𮉝	vfyhs
𮈹	vfyie
𮉉	vfyle
𮉓	vfymu
𮉕	vfymu
𮉅	vfyni
𮈺	vfypd
𮉘	vfyra
𮉙	vfysq
𮈴	vfytt
𮝲	vfyv
𮈴	vfyyj
𭒉	vhae
𭅼	vhail
𭀗	vhiu
𭒤	vhkb
𭒧	vhok
𭝇	vhp
𬼴	vhtcn
𮞀	vhtwv
𭒥	vhxs
𭧡	via
𭞉	vidp
𭅩	vij
𭙊	vimn
𬿠	viom
𭟄	vip
𭙋	vipim
𭒳	vipo
𭙈	vis
𭑺	vit
𭒝	viv
𭙌	vivs
𭤛	viyk
𭒨	vjcb
𭒛	vjpu
𭾎	vkbt
𮇬	vkofd
𭑸	vlbv
𭔬	vlnii
𬻲	vlshi
𬻲	vlshi
𬻲	vlsk
𭑽	vlsp
𭒫	vlvk
𮕎	vlwi
𮉭	vmahu
𭒦	vmak
𭒢	vmbd
𭒩	vmbe
𮉦	vmbkk
𮉯	vmbof
𭷅	vmgdi
𮉤	vmgg
𭷈	vmgni
𮉫	vmhdv
𮉢	vmhqo
𭷂	vmih
𭶾	vmjk
𭷃	vmjr
𮉠	vmkn
𭁟	vml
𭒪	vmmc
𬻤	vmmn
𮉥	vmmnn
𮉧	vmmob
𭷁	vmok
𮉣	vmos
𭜎	vmp
𭷀	vmqo
𮉨	vmrob
𭛏	vmrt
𮉩	vmryo
𮉪	vmsje
𭷆	vmsme
𭷄	vmtc
𭑾	vmth
𭒭	vmtp
𮉮	vmuog
𮊷	vmwlq
𭛑	vmwol
𮉬	vmyoj
𮉡	vmys
𭷇	vmytp
𭶿	vmyv
𭍼	vngi
𭒠	vnhb
𭒃	vnhx
𭑴	vnih
𭒜	vnlw
𭄄	vnsh
𭒗	vnwu
𭒙	voib
𭝆	vop
𭒚	vorb
𭒬	vorb
𮌩	vorbq
𭯰	vorvp
𭑯	vpk
𭑫	vps
𭑮	vq
𭢱	vqklu
𭒎	vqku
𭑼	vrd
𭄥	vrks
𬼤	vrn
𭚯	vrn
𭎍	vsg
𭑪	vsh
𭒅	vsjl
𭒆	vslu
𮋑	vssmm
𭑵	vsv
𭄹	vswks
𭑻	vswl
𭭠	vsylm
𭒮	vtaa
𭒣	vtbo
𭒏	vtgf
𭑹	vtk
𭒔	vtmr
𭒡	vtxf
𭥝	vua
𭝉	vup
𮠅	vurau
𭒌	vveq
𭒟	vvfg
𭒵	vvfv
𭐟	vvhe
𭀘	vvhu
𭀜	vvhu
𭒋	vvmj
𭗽	vvmk
𭗺	vvp
𭗼	vvu
𭗾	vvuk
𭗿	vvyni
𭑱	vwl
𭒇	vwpp
𭅫	vxrr
𭑧	vy
𬻻	vyg
𭒖	vyko
𭒑	vyrb
𭑬	vyv
𭥫	wa
𭟛	wap
𭻶	wate
𭻆	wau
𮮗	wbf
𮂭	wbotf
𭕂	wcdi
𮚣	wcgp
𭍛	wci
𮚙	wcjr
𭅂	wcks
𭻘	wcnh
𭍹	wcnln
𭻗	wcor
𭻃	wcsh
𭍳	wcwa
𮚜	wcyg
𭻜	wdd
𮮘	wdf
𭮲	wdhne
𭄰	wdks
𭪻	wdohh
𭪥	wdoin
𭪥	wdomn
𭪹	wdpr
𭻔	wdt
𮖐	wdyhv
𭻅	we
𭍟	wem
𭍰	weog
𮋏	wesmm
𭥴	wfa
𮮔	wfcsh
𮮙	wfdd
𭻞	wff
𮭒	wfhaf
𮮛	wfjrr
𮮖	wfyt
𮮚	wfytr
𭴬	wgf
𭍝	wgi
𮡜	wgmjk
𭐑	wgmk
𮡒	wgmmi
𭐑	wgnjk
𮡜	wgnjk
𮭧	wgpym
𮡓	wgrjs
𮡔	wgrms
𮡙	wgsmv
𭍵	whbt
𭻱	whdw
𭍚	whn
𭻊	whso
𭻖	whvf
𭻀	wi
𭍫	wiff
𭎢	wig
𭤦	wihml
𭍩	wihr
𭻒	wike
𭷍	willl
𭻁	wje
𭻠	wjpd
𭻪	wjpr
𭻇	wjr
𭺾	wjt
𭺿	wke
𮬴	wkhaf
𭍢	wkhg
𭟟	wkp
𭻝	wlab
𮊉	wlahb
𮊋	wlbjj
𮊑	wlebd
𮊈	wleyg
𮊛	wlffu
𭻡	wlhg
𮊒	wlibi
𮊅	wlihs
𮉿	wlik
𮉽	wlip
𮊍	wljbc
𮊍	wljuc
𮊝	wlmfu
𮊚	wlmlw
𭻎	wlmnn
𮊃	wlohh
𭾬	wloi
𮊠	wlsfr
𮊕	wlsma
𮊙	wlsma
𮊡	wltjf
𮒅	wltpd
𮊐	wltqu
𮊟	wlvfc
𭾪	wlvhv
𮊂	wlwll
𭾱	wlyhv
𭍫	wmff
𭍱	wmgg
𭺙	wmhvo
𭍷	wmirm
𭍲	wmoll
𮬽	wnhaf
𭍣	wnis
𭜪	wnp
𭻐	wnsd
𭍯	wnwf
𭍞	woa
𭝾	wobtp
𮨃	wombc
𭍴	womo
𭻰	woom
𭍜	wosu
𭟜	wpllp
𭻲	wpsjl
𭻽	wptvd
𭍬	wqmc
𭶑	wrf
𮕔	wrfli
𭍡	wri
𭍮	wrirm
𭻵	wrrm
𭍪	wrsj
𭍨	wruu
𭻮	wsjir
𭻟	wsklg
𭻚	wspru
𭻤	wssql
𭻥	wtcp
𭻳	wtgi
𭍸	wtox
𬼮	wtpd
𭍦	wtys
𮫢	wuhdv
𭤌	wvok
𭻕	wwg
𭻹	wwjw
𭍭	wwtc
𭐍	wwwg
𭻸	wwwm
𭷶	wwwq
𭻼	wwykn
𭍧	wymb
𭍤	wytj
𮞪	yabr
𮧸	yadhe
𭅯	yah
𮧻	yaikp
𮟕	yaja
𮞡	yame
𬽊	yand
𬽉	yann
𮟥	yanq
𮟌	yaog
𮧽	yaoge
𮧷	yasu
𮧾	yatmc
𬽔	yauk
𮪻	ybanq
𬽚	ybbh
𮚘	ybbuc
𭪢	ybd
𬽖	ybdoo
𮪼	ybeed
𭶟	ybff
𮟅	ybhk
𭮿	ybhne
𮪹	ybike
𮪹	ybikk
𭘳	yblbv
𭘽	ybmfb
𬽈	ybmm
𭘳	ybmv
𮕫	ybmv
𭘬	ybpd
𭋚	ybrp
𮞉	ybru
𭘐	ybruc
𮖬	ybrv
𭅾	ybsl
𬽝	ybuh
𭾛	ybuh
𮟒	ybut
𮫧	ybwui
𮖟	ybyhv
𮖭	ybyhv
𭴢	ycf
𭵐	ycf
𭎭	ycg
𮖋	ycgcv
𮬭	ychaf
𭛚	ychhh
𭯬	ychqu
𭐦	ycmhe
𮟮	ycnl
𭟪	ycp
𮭣	ycpym
𮜫	ycryo
𮞧	ycsb
𭁖	ycvne
𭁛	ycyhj
𮟝	yddj
𮟘	yddq
𮞝	ydhl
𭮸	ydhne
𮞖	ydio
𭓔	ydkni
𮦀	ydog
𭣾	ydok
𭤆	ydok
𮋈	ydsmm
𮄾	ydtak
𭣸	ydye
𮈀	yefd
𮠯	yemcw
𮁹	yemmf
𮀜	yemr
𮬞	yenwm
𮛣	yeryo
𮞵	yeyr
𬽄	yf
𮞢	yfbr
𮟟	yfdu
𭶥	yfff
𭟸	yfiho
𬽙	yfijb
𭕒	yfiku
𭚤	yfipm
𮥵	yfle
𮞭	yfmr
𭣬	yfok
𭭳	yfomd
𭤐	yfye
𭩌	ygbkk
𮮜	ygf
𮞗	ygit
𭩕	ygjbm
𭄴	ygks
𮨉	ygmbc
𭩔	ygndt
𬻽	ygnyk
𭟦	ygp
𭃌	ygsh
𮟊	ygth
𮮏	ygtlc
𮮏	ygtmc
𮟧	ygvl
𭻙	ygwks
𬻾	ygyhr
𮞰	yhae
𮤓	yhan
𮞽	yhas
𮞾	yhas
𮓢	yhcb
𮖥	yhdv
𮓚	yhe
𮞓	yhed
𮞦	yhed
𮞑	yher
𮭘	yhhaf
𭂸	yhhn
𮟐	yhhr
𮟆	yhmm
𭛛	yhoa
𮞺	yhq
𮟄	yhrm
𮟣	yhur
𮟗	yhus
𮞅	yhv
𮞱	yhwj
𮟦	yhwo
𮞴	yhxg
𬽑	yhxo
𭁩	yibmm
𭏼	yig
𮞔	yihg
𭐤	yihue
𮞩	yihv
𮞲	yiil
𮖠	yiiv
𮞇	yikp
𮞨	yilo
𮞳	yilo
𮞻	yilr
𮟴	yinl
𭜘	yip
𮞲	yisl
𭤞	yiyj
𮟜	yiyl
𮝽	yjawe
𮟇	yjcs
𭶈	yjff
𮟙	yjig
𭅭	yjmbb
𭮧	yjmnj
𮞼	yjmo
𮄴	yjno
𭤊	yjok
𮟡	yjti
𮟏	yjto
𮞚	yjtu
𮞸	yjwa
𭙇	yjyja
𭯱	yjyji
𭯱	yjyjm
𭤘	ykam
𭑁	ykbhx
𮞜	ykbr
𮢸	ykc
𭎲	ykg
𭐺	ykhg
𬽟	ykhlc
𭤚	ykirp
𭄾	ykks
𭤔	yklb
𮚁	ykll
𮕁	yklmi
𮨂	ykmbc
𭑛	ykmfr
𭤕	ykmmf
𭐻	ykmmi
𭺡	ykmvn
𭤗	ykmym
𭭉	ykno
𭭎	ykno
𮇬	ykofd
𮟁	ykog
𮥷	ykog
𭐿	ykoir
𮀉	ykomd
𭯑	ykpp
𭭧	ykse
𭼃	yksno
𭼅	yktyo
𭗟	ykyck
𭑎	ykyj
𮘝	ykymr
𭏇	ylg
𭏻	ylg
𮭌	ylhaf
𬽏	ylkv
𭺦	ylmvn
𮞌	yln
𬺾	ylu
𮮽	ylvo
𮞯	ylwa
𭾴	ymahu
𮌈	ymb
𭭞	ymbm
𮟚	ymbs
𮗞	ymbuu
𮓩	ymcms
𭭵	ymddf
𮞛	ymeb
𭭰	ymefk
𭭝	ymf
𮞘	ymfb
𮞙	ymfg
𮭐	ymhaf
𭪠	ymhed
𭛚	ymhhh
𮞆	ymhl
𭭜	ymhml
𭭙	ymhn
𭟼	ymi
𭕐	ymiku
𭭨	ymkmr
𮞛	ymlb
𮞏	ymmb
𮞁	ymmm
𭭢	ymmmr
𭭼	ymnii
𮓪	ymnin
𮓪	ymnin
𭭔	ymno
𮞃	ymo
𭣫	ymok
𭪠	ymokd
𭭶	ymomo
𭭺	ympik
𭭷	ympko
𭭦	ymqmb
𮞄	ymr
𮞷	ymrr
𭭤	ymryo
𮛅	ymryo
𭭟	ymsmr
𭭥	ymtgo
𮞶	ymwd
𮟀	ymwi
𮟀	ymwl
𭭚	ymy
𭭛	ymye
𭭴	ymymm
𬽗	ynau
𮓧	yncor
𮓯	ynfdq
𮓮	ynfhf
𮕩	yngv
𮕞	ynhbt
𮓗	ynhg
𮓟	ynhn
𮓤	ynhq
𬽛	ynilp
𬽆	ynio
𬽇	ynip
𭣙	ynje
𮟠	ynlq
𭭿	ynmvs
𭭖	ynno
𬽃	ynnu
𭭄	yno
𭝵	ynp
𭭾	ynp
𬼭	ynpd
𬽓	ynpd
𭞇	ynph
𮓨	ynrmu
𮊯	yntq
𮡢	ynwgn
𬽞	ynyhl
𮄽	ynyt
𮞕	ynyv
𮕻	yoav
𮟞	yofb
𮞋	yog
𮞊	yoii
𮞤	yoip
𭅃	yoks
𮞣	yoli
𮞊	yoml
𮞤	yomp
𬽋	yoog
𮖚	yoov
𭞗	yop
𭟔	yop
𮟎	yora
𭤜	yoyj
𮓣	ypbjs
𭎭	ypcg
𭪿	ypdl
𮓛	ypg
𮞥	yphp
𮝏	ypjwj
𮟂	ypmc
𮯚	ypomr
𮓝	ypyo
𮟖	yqmc
𮞒	yqme
𮟉	yqpd
𮟢	yqwj
𭫋	yrad
𮘼	yraja
𮘚	yrbb
𮙀	yrbbe
𬽎	yrbi
𮔯	yrbi
𮘦	yrbla
𮘙	yrbmm
𮘑	yrbms
𮘄	yrbq
𮪸	yrbv
𭭲	yrcor
𮗼	yrd
𮘢	yrdbu
𮘀	yrdj
𮘪	yrdmb
𭭬	yreg
𭴙	yrf
𮙃	yrfhf
𮘞	yrfqs
𮘏	yrgil
𮘰	yrgji
𮘮	yrhai
𮘴	yrhhk
𮘌	yrhhv
𮗸	yrhn
𮞈	yrhu
𮟛	yrif
𮘶	yrilb
𮘾	yrjbk
𮘜	yrjcm
𮘛	yrjcs
𮘨	yrjhr
𮗾	yrji
𮘵	yrjmc
𮗹	yrk
𮘋	yrkhu
𮘊	yrkym
𮘁	yrlwu
𮘿	yrmbi
𮘿	yrmbl
𮞐	yrms
𮘉	yrmtn
𮟓	yrmu
𮙁	yrnbq
𮟼	yrnl
𮘇	yrnyo
𮘍	yrobm
𮘓	yroha
𭭭	yroii
𮘅	yromj
𭭭	yroml
𮙄	yromp
𮗽	yrpp
𮘗	yrqkq
𮘒	yrrd
𮘂	yrre
𮥿	yrrg
𮞮	yrrj
𮞬	yrrr
𮘲	yrrrs
𬽐	yrrv
𮘕	yrshu
𮗷	yrsl
𮘖	yrsql
𮘸	yrssf
𮘫	yrtcp
𮘡	yrtlk
𮘺	yrtmc
𮘹	yrtso
𮗻	yrtt
𮙈	yrtvg
𮘥	yrukd
𮟩	yrwg
𮘬	yrwlm
𮟍	yryb
𮙅	yryci
𭣿	yrye
𮘣	yryic
𮘣	yryid
𮙂	yryid
𮘷	yrykm
𮘘	yrylh
𮙅	yrymi
𮘯	yryom
𮘔	yryon
𮘭	yrypk
𮝼	yrytj
𮘟	yrytr
𮘩	yrytr
𮙆	yrytr
𮘈	yryuo
𭤿	ysbme
𭤲	ysfq
𭤮	yshhd
𭤱	yshio
𭤷	yshon
𭤯	yshqm
𭤩	ysi
𭤽	ysili
𭤫	ysl
𭤬	yslll
𮟤	yslr
𭥇	ysmfb
𭤺	ysnkb
𭤨	yso
𮮼	ysoa
𭤸	ysoau
𮋡	ysob
𮟈	ysog
𮔰	ysoi
𮮻	ysol
𬽒	ysom
𭤻	ysomm
𭤰	ysoym
𭥃	ysoyr
𭤶	yssj
𭤴	yssp
𭥀	ysstt
𭤾	yssuu
𭥀	yssyj
𭥅	ystav
𭥉	ystcv
𮟨	ystj
𭤭	ystm
𭥉	ystov
𭥈	ysumj
𮮺	ysvb
𭅴	ysy
𭥁	ysybs
𭤼	ysyrf
𭥄	ysyso
𭤳	ysyt
𭥆	ysywm
𮄱	ytab
𮄸	ytawe
𮟔	ytbo
𮓬	ytcms
𮄷	ytcmt
𬽌	ytd
𭽷	ytdhe
𮄧	ytdi
𭕉	ytf
𮄭	ytgg
𮄨	ythlo
𮄫	ythqm
𮞍	yths
𮞠	ythv
𮟋	ythv
𮄼	ytjju
𮞿	ytjs
𬽍	ytju
𮄩	ytkm
𮄲	ytkmr
𮨜	ytmbc
𮄪	ytmfj
𮕱	ytmv
𮄯	ytnib
𮞫	ytnu
𮄶	ytomn
𮄶	ytomv
𮄮	ytpa
𮞞	ytq
𮄵	ytqka
𮄰	ytrhg
𮄰	ytrmg
𮄺	ytsmt
𮄷	yttct
𮄬	ytuu
𮟑	ytvg
𮄻	ytwgf
𮄿	ytwuu
𮙇	ytybp
𮞟	ytym
𮄳	ytyok
𮄹	ytytu
𮯅	yuav
𬽘	yubcr
𮚦	yubuc
𮓧	yucor
𮮿	yudi
𮯆	yudso
𭵮	yuf
𮇦	yufd
𮓯	yufdq
𮓮	yufhf
𭗤	yugv
𮯄	yuhbr
𮯌	yuhlb
𮓟	yuhn
𮓤	yuhq
𮯍	yuite
𮯕	yukwv
𮯊	yule
𮕀	yulmi
𮯔	yumbb
𮯙	yumnr
𮯂	yumr
𮞹	yumw
𮯀	yuno
𮯉	yuofd
𮯘	yuomb
𮯈	yuomo
𮮾	yup
𮓨	yurmu
𮯋	yurrs
𮯇	yuryo
𮯃	yushr
𮯎	yusmg
𮯖	yutqb
𮯒	yuumg
𮯁	yuyj
𮯗	yuypk
𮯓	yuypm
𮯑	yuypu
𮯐	yuywv
𮕺	yvbmr
𭪑	yvdd
𭴆	yve
𮞎	yve
𬽠	yvfe
𬽜	yvfg
𭀚	yvhu
𮘎	yvii
𭄸	yvks
𮨁	yvmbc
𮨖	yvmbc
𮨛	yvmbc
𮠙	yvmcw
𮠍	yvnl
𭭖	yvno
𭤑	yvok
𭪭	yvptd
𮊤	yvtq
𮊵	yvwln
𮚨	yvwlu
𭫪	ywd
𮭮	ywdoo
𭵜	ywgf
𭅰	ywh
𮭬	ywice
𭕓	ywiku
𮭫	ywjr
𬽕	ywlh
𮟃	ywlv
𮠄	ywnl
𮭯	ywrrs
𮭰	ywyhn
𭔮	yydi
𭅱	yykd
𭃏	yyln
𮞂	yyn
𭤹	yyo
𬿎	yyomm
𬽅	yyr
𭃐	yysh
𭤜	yyyj